AAAAA DBHEG AADEA IAABC CHFCF HFIAI FGDJB JFGAD CAGIC HCIJJ GJIAF EDAHF GFJEH CDIBJ EBGCF JCIDF IDJFG DFDGC ABIIF CCBEB AGGEI HFIAI FGDJB JFGAD AJDDF HDEDC DDCHG EHJIB EHADG FABJA ACEEH DBECE FIHJH AFGAD IGABJ BHDGA FGDJB JFGAD IDAED GBDCF DCIBA ACGBJ IHCBD IHAII HBGBI EHBAJ FGDJB JFGAD EAICH ACEAB CEAJH
IGABJ: BHDGA
GFJEH: CDIBJ
JFGAD: CAGIC,AJDDF,IDAED,EAICH
AADEA: IAABC
EAICH: ACEAB
ACEAB: CEAJH
CHFCF: HFIAI
DFDGC: ABIIF
AFGAD: IGABJ
CEAJH: 
ABIIF: CCBEB
IHCBD: IHAII
GJIAF: EDAHF
HFIAI: FGDJB,FGDJB
HFIAI HFIAI HFIAI HFIAI HFIAI HFIAI HFIAI HFIAI HFIAI HFIAI HFIAI HFIAI HFIAI HFIAI HFIAI HFIAI HFIAI HFIAI HFIAI HFIAI HFIAI HFIAI HFIAI HFIAI HFIAI HFIAI HFIAI HFIAI HFIAI HFIAI HFIAI HFIAI HFIAI HFIAI HFIAI HFIAI HFIAI HFIAI HFIAI HFIAI HFIAI HFIAI HFIAI HFIAI HFIAI HFIAI HFIAI HFIAI HFIAI HFIAI 
AAAAA HCADI GFGBB HJBCI FEFCD FFAGI EBEFC AEHJH CCAAA GDCDA DJCJH GIAEA JIJII HBEEI DHEHJ CDGIB CABEI BFGJI BHFFH CFEDI AEAHA HBJFD GJCHG IGIBF AFGIB HBGGI DHEHJ CDGIB FGCGH FEADA JFFAH BFDIJ JDHIB DJADD FDJBF AFGIB DGDEJ JIJII HBEEI DHEHJ CDGIB DJEFF HJFCG GIBJC JICBJ EHBGF HAFJI ICEEA HFDGG CCAGH FFDJH
CDGIB: CABEI,FGCGH,DJEFF
DGDEJ: JIJII
HAFJI: ICEEA
HFDGG: CCAGH
CCAGH: FFDJH
GIBJC: JICBJ
FEFCD: FFAGI
HCADI: GFGBB
GJCHG: IGIBF
AEHJH: CCAAA
FFAGI: EBEFC
DJADD: FDJBF
AAAAA: HCADI
JDHIB: DJADD
HJFCG: GIBJC
JIJII: HBEEI,HBEEI
JIJII JIJII JIJII JIJII JIJII JIJII JIJII JIJII JIJII JIJII JIJII JIJII JIJII JIJII JIJII JIJII JIJII JIJII JIJII JIJII JIJII JIJII JIJII JIJII JIJII JIJII JIJII JIJII JIJII JIJII JIJII JIJII JIJII JIJII JIJII JIJII JIJII JIJII JIJII JIJII JIJII JIJII JIJII JIJII JIJII JIJII JIJII JIJII JIJII JIJII 
AAAAA HGFBH BIECC CJFAJ CEEJG EIIEJ IHCEB FGFAG CDEBA DFJBH ABFHA GBJGG HIGDJ EIDED JABBD JBIJD FAIDI AJHHD EBECA GJIEB DHBEG DFJBH GBJGG HIGDJ CEAIH IAJIF FCABB ABGJE EHCHC IGFEA DFJBH ABFHA HADFI GBJGG HIGDJ EBABE DAEDC EBCFA HIABC GGAHI HGFCA FAACB HADCI ADBEG CJHJE IBEBC DEJDA HADFI GBJGG HIGDJ IIJIA
ADBEG: CJHJE
EBCFA: HIABC
FAACB: HADCI
HIABC: GGAHI
ABGJE: EHCHC
CJHJE: IBEBC
CJFAJ: CEEJG
IGFEA: DFJBH
FGFAG: CDEBA
DEJDA: HADFI
DFJBH: ABFHA,GBJGG,ABFHA
EHCHC: IGFEA
AAAAA: HGFBH
IBEBC: DEJDA
IIJIA: 
EIDED: JABBD
AJHHD: EBECA
ABFHA: GBJGG,HADFI
JABBD: JBIJD
JBIJD: FAIDI
BIECC: CJFAJ
CDEBA: DFJBH
CEAIH: IAJIF
HGFCA: FAACB
HADCI: ADBEG
FAIDI: AJHHD
GBJGG: HIGDJ,HIGDJ,HIGDJ,HIGDJ
GBJGG GBJGG GBJGG GBJGG GBJGG GBJGG GBJGG GBJGG GBJGG GBJGG GBJGG GBJGG GBJGG GBJGG GBJGG GBJGG GBJGG GBJGG GBJGG GBJGG GBJGG GBJGG GBJGG GBJGG GBJGG GBJGG GBJGG GBJGG GBJGG GBJGG GBJGG GBJGG GBJGG GBJGG GBJGG GBJGG GBJGG GBJGG GBJGG GBJGG GBJGG GBJGG GBJGG GBJGG GBJGG GBJGG GBJGG GBJGG GBJGG GBJGG 
AAAAA DAHDE FDJFJ EJAGI AJGBI BACFB DBIJE ADEBH BHIBI EDEFG IEDIJ ABEIJ CDCIB CGGEJ EFFFH BDJHB HEDHG FICDB JJCHG IAAFF CIGJE IHIDA AEGCI CJICJ HHJCI EFFFH BDJHB EAJJE BFDIF BEEEI BBFBH JHAFD EBCIG BFEAI EIHFD CCEIJ BAIGJ ICGDE HHJCI IEDCD EFFFH BDJHB JJFDF JEBBF HEDBI JAEHG HBDCH HIBHH AHHBC CCEBI IDDHA
CGGEJ: EFFFH
EBCIG: BFEAI
CCEBI: IDDHA
AJGBI: BACFB
CCEIJ: BAIGJ
BFDIF: BEEEI
BDJHB: HEDHG,EAJJE,JJFDF
EDEFG: IEDIJ
AEGCI: CJICJ
BAIGJ: ICGDE
DBIJE: ADEBH
IAAFF: CIGJE
JAEHG: HBDCH
IEDIJ: ABEIJ
BFEAI: EIHFD
AAAAA: DAHDE
HIBHH: AHHBC
AHHBC: CCEBI
JJCHG: IAAFF
JJFDF: JEBBF
HHJCI: EFFFH,IEDCD
BBFBH: JHAFD
EJAGI: AJGBI
ICGDE: HHJCI
FDJFJ: EJAGI
IDDHA: 
BHIBI: EDEFG
BACFB: DBIJE
EAJJE: BFDIF
BEEEI: BBFBH
ADEBH: BHIBI
IEDCD: EFFFH
CIGJE: IHIDA
EFFFH: BDJHB,BDJHB,BDJHB
EFFFH EFFFH EFFFH EFFFH EFFFH EFFFH EFFFH EFFFH EFFFH EFFFH EFFFH EFFFH EFFFH EFFFH EFFFH EFFFH EFFFH EFFFH EFFFH EFFFH EFFFH EFFFH EFFFH EFFFH EFFFH EFFFH EFFFH EFFFH EFFFH EFFFH EFFFH EFFFH EFFFH EFFFH EFFFH EFFFH EFFFH EFFFH EFFFH EFFFH EFFFH EFFFH EFFFH EFFFH EFFFH EFFFH EFFFH EFFFH EFFFH EFFFH 
AAAAA BICJG GCAJB JGADC FICFF AACFG DDGAG EHCFE BBBIC FIJCG BHBID HBHFC EBFJI HHFHF EABJA BAHAI EHIJI DJHHJ CHBGJ DFJBJ CEHDB IBACE HHHAF AJJGC HGEIJ IBHFF EABJA BAHAI BJGGD BEIJJ JBFBA IGCJI BCIHG DBAEC CCBHD JABAD FIEED DAHHB EBFJI IBHFF HHFHF EABJA BAHAI JACCC GIJFC CDHEJ GHGCG HHCBG CJJHC CHJFA BAHJD
AACFG: DDGAG
FICFF: AACFG
GIJFC: CDHEJ
JGADC: FICFF
BHBID: HBHFC
CHJFA: BAHJD
EHIJI: DJHHJ
DFJBJ: CEHDB
EABJA: BAHAI,BAHAI,BAHAI
EABJA EABJA EABJA EABJA EABJA EABJA EABJA EABJA EABJA EABJA EABJA EABJA EABJA EABJA EABJA EABJA EABJA EABJA EABJA EABJA EABJA EABJA EABJA EABJA EABJA EABJA EABJA EABJA EABJA EABJA EABJA EABJA EABJA EABJA EABJA EABJA EABJA EABJA EABJA EABJA EABJA EABJA EABJA EABJA EABJA EABJA EABJA EABJA EABJA EABJA 
AAAAA FHHAA CJCFA GBFJA ACFGJ ABBFI GHGBI DJBAE GBJBH GIECG JFJJC IDEIE GJAIH CHBID ADHDA GBJBH GIECG HJIDC GDIGE JJDFB BHBHA CCGBF DCJEG CHBID ADHDA GBJBH GIECG BEABH HBHJI IDDGB IGCBA HGBHH CDHHC BHHBJ FIFDD JBCDG CGFBC CHBID GBJBH GIECG FDHFJ GAAIH BGEJJ JFAJD HFFDG AGAFF HEEDC BGBFG EDFAI ABFEI GBJBH
JJDFB: BHBHA
GDIGE: JJDFB
BHHBJ: FIFDD
BGEJJ: JFAJD
IDEIE: GJAIH
EDFAI: ABFEI
ABFEI: GBJBH
ACFGJ: ABBFI
HFFDG: AGAFF
HJIDC: GDIGE
IDDGB: IGCBA
DJBAE: GBJBH
CGFBC: CHBID
CCGBF: DCJEG
AAAAA: FHHAA
IGCBA: HGBHH
BGBFG: EDFAI
CJCFA: GBFJA
BEABH: HBHJI
FIFDD: JBCDG
AGAFF: HEEDC
GAAIH: BGEJJ
GHGBI: DJBAE
FDHFJ: GAAIH
ABBFI: GHGBI
CHBID: ADHDA,ADHDA,GBJBH
ADHDA: GBJBH,GBJBH
ADHDA ADHDA ADHDA ADHDA ADHDA ADHDA ADHDA ADHDA ADHDA ADHDA ADHDA ADHDA ADHDA ADHDA ADHDA ADHDA ADHDA ADHDA ADHDA ADHDA ADHDA ADHDA ADHDA ADHDA ADHDA ADHDA ADHDA ADHDA ADHDA ADHDA ADHDA ADHDA ADHDA ADHDA ADHDA ADHDA ADHDA ADHDA ADHDA ADHDA ADHDA ADHDA ADHDA ADHDA ADHDA ADHDA ADHDA ADHDA ADHDA ADHDA 
AAAAA FEJHD DBCHH BEHJC CIIAH CJAID CBAGG BFIJF AHFHD GCJEJ AEDIB EEGHH DEFHG ADHEG HJAGJ HEIBA IJBIB GAFJC IIFBA JGJAI HGIHI GCJEJ AEDIB GDBHB HAJDH ADJGI AGAIE IECFA BIHBI CBIFD JBHAA AHFHD GCJEJ AEDIB GHDDD IGAIB FJGDI AEDAH FDJGH GDHFA EDGFA CEHCG EGGFF BGBAC IFIFC HIICA GCJEJ AEDIB GCAGI BBDGG BEHIB
JBHAA: AHFHD
BEHJC: CIIAH
CEHCG: EGGFF
IFIFC: HIICA
FEJHD: DBCHH
BEHIB: 
FJGDI: AEDAH
CIIAH: CJAID
IECFA: BIHBI
BGBAC: IFIFC
HAJDH: ADJGI
HEIBA: IJBIB
AGAIE: IECFA
IGAIB: FJGDI
IJBIB: GAFJC
BBDGG: BEHIB
GCAGI: BBDGG
AAAAA: FEJHD
HJAGJ: HEIBA
ADHEG: HJAGJ
FDJGH: GDHFA
CBIFD: JBHAA
GDBHB: HAJDH
EGGFF: BGBAC
BFIJF: AHFHD
GCJEJ: AEDIB,AEDIB,AEDIB,AEDIB
GCJEJ GCJEJ GCJEJ GCJEJ GCJEJ GCJEJ GCJEJ GCJEJ GCJEJ GCJEJ GCJEJ GCJEJ GCJEJ GCJEJ GCJEJ GCJEJ GCJEJ GCJEJ GCJEJ GCJEJ GCJEJ GCJEJ GCJEJ GCJEJ GCJEJ GCJEJ GCJEJ GCJEJ GCJEJ GCJEJ GCJEJ GCJEJ GCJEJ GCJEJ GCJEJ GCJEJ GCJEJ GCJEJ GCJEJ GCJEJ GCJEJ GCJEJ GCJEJ GCJEJ GCJEJ GCJEJ GCJEJ GCJEJ GCJEJ GCJEJ 
AAAAA JCDIF GFEBB FDCCF JACIH GFJDA ADHDI AGDJG ABFFG FHFJI EDHGH FEBGJ JGBFH DDIHA IFBBE ACBBF EDEEI GACDA FJBFA FGABI IJEEH IJFJF BBIGD DIGHD AJEJH JFDGI BCJCE DCHAI DIEIB BDDIF HEFFC AGHDF EDEEI DJHEG AJBED CHCCJ FGABI IJEEH JEIAI EBACF IGHCG CGCEH HJHAH FCAAI DDHJF BFEFJ FJHGG FJBFA FGABI IJEEH FABIC
BCJCE: DCHAI
DDIHA: IFBBE
JCDIF: GFEBB
DJHEG: AJBED
FJHGG: FJBFA
ACBBF: EDEEI
EDEEI: GACDA,DJHEG
GACDA: FJBFA
JGBFH: DDIHA
DIGHD: AJEJH
BDDIF: HEFFC
AGHDF: EDEEI
ADHDI: AGDJG
CHCCJ: FGABI
BBIGD: DIGHD
AJEJH: JFDGI
FDCCF: JACIH
AAAAA: JCDIF
EDHGH: FEBGJ
JEIAI: EBACF
JFDGI: BCJCE
EBACF: IGHCG
FGABI: IJEEH,IJEEH,IJEEH
FGABI FGABI FGABI FGABI FGABI FGABI FGABI FGABI FGABI FGABI FGABI FGABI FGABI FGABI FGABI FGABI FGABI FGABI FGABI FGABI FGABI FGABI FGABI FGABI FGABI FGABI FGABI FGABI FGABI FGABI FGABI FGABI FGABI FGABI FGABI FGABI FGABI FGABI FGABI FGABI FGABI FGABI FGABI FGABI FGABI FGABI FGABI FGABI FGABI FGABI 
AAAAA JGAFG ADCJH HJJEH DHJBI AIDGI EIEAA HDHGB IJJEF DACAA DFDCI FCEJH GFBFC AIGEH DJJCE DBBGD HBIFA IDIFF BGDJA HCCGJ HJDBI CGFDA EGGCG AJEAF FCEJH GFBFC HIIHC IDHJG HGHJI HEAAA GCCBG EAAIG EIIFD DEEJG DACAA DFDCI FCEJH GFBFC BBEGA DIAJG BJDAC AICCH DAHCB BGHEG CAEEG HAJEF AHBJB DDHJA ACBBA EGGCG FCEJH
FCEJH: GFBFC,GFBFC,GFBFC
FCEJH FCEJH FCEJH FCEJH FCEJH FCEJH FCEJH FCEJH FCEJH FCEJH FCEJH FCEJH FCEJH FCEJH FCEJH FCEJH FCEJH FCEJH FCEJH FCEJH FCEJH FCEJH FCEJH FCEJH FCEJH FCEJH FCEJH FCEJH FCEJH FCEJH FCEJH FCEJH FCEJH FCEJH FCEJH FCEJH FCEJH FCEJH FCEJH FCEJH FCEJH FCEJH FCEJH FCEJH FCEJH FCEJH FCEJH FCEJH FCEJH FCEJH 
AAAAA HDGEA IHCGB JHHJE HEFDC IGICH HFFCF JHEGD GBGHD CJDGB ACEDF AFJHI FBCIE FHHBA BEICF FFHJE EGEBH AJIDI BBIEB AGBED CBIEB HJEIH EJCCB IEGJI JBDFG IEGFI BAJAB EECGE EEDGD EGEBH AJIDI AFBCJ FDEAD BBHAI HCAIH JBFJG CFHJH GDGFI EFFIE JGCAG HAEBI JDICG EACDD FBGAD GICFB FIJAE EAFIA EGEBH AJIDI JEFHD CEICI
HJEIH: EJCCB
EJCCB: IEGJI
HEFDC: IGICH
EAFIA: EGEBH
JGCAG: HAEBI
IEGJI: JBDFG
HDGEA: IHCGB
CEICI: 
HFFCF: JHEGD
JDICG: EACDD
EECGE: EEDGD
JHEGD: GBGHD
CBIEB: HJEIH
ACEDF: AFJHI
BBHAI: HCAIH
BEICF: FFHJE
AGBED: CBIEB
AAAAA: HDGEA
HAEBI: JDICG
EEDGD: EGEBH
EGEBH: AJIDI,AJIDI,AJIDI
EGEBH EGEBH EGEBH EGEBH EGEBH EGEBH EGEBH EGEBH EGEBH EGEBH EGEBH EGEBH EGEBH EGEBH EGEBH EGEBH EGEBH EGEBH EGEBH EGEBH EGEBH EGEBH EGEBH EGEBH EGEBH EGEBH EGEBH EGEBH EGEBH EGEBH EGEBH EGEBH EGEBH EGEBH EGEBH EGEBH EGEBH EGEBH EGEBH EGEBH EGEBH EGEBH EGEBH EGEBH EGEBH EGEBH EGEBH EGEBH EGEBH EGEBH 
AAAAA BAJJB BBEGC BDDIF AJADD BCCCF EGFDE IICJI BDEAF CCEIH HGHDB BCCJE GFHJF BABEB FIBHC ADGAA CECHA GIGJB HJJBF DBGAD AJADD EJHAE IICJI BDEAF HHCDI CFEJI GFJBG CIHAA DAHID ADCBC CIIBF HHHDG AEEBA AJADD DDACD IICJI BDEAF AACII ICJCA GDCJI IHJFC IGAGC BADHC JICEH GEHIH BCCCF EJHAE EGFDE IICJI BDEAF GGGJA
BABEB: FIBHC
BAJJB: BBEGC
DDACD: IICJI
AACII: ICJCA
GDCJI: IHJFC
JICEH: GEHIH
BADHC: JICEH
AJADD: BCCCF,EJHAE,DDACD
BCCJE: GFHJF
ADCBC: CIIBF
CECHA: GIGJB
BDEAF: CCEIH,HHCDI,AACII,GGGJA
BDDIF: AJADD
HHCDI: CFEJI
GFJBG: CIHAA
GGGJA: 
IGAGC: BADHC
FIBHC: ADGAA
CIHAA: DAHID
CCEIH: HGHDB
AAAAA: BAJJB
GEHIH: BCCCF
ICJCA: GDCJI
CIIBF: HHHDG
HHHDG: AEEBA
IHJFC: IGAGC
GFHJF: BABEB
DBGAD: AJADD
DAHID: ADCBC
EJHAE: IICJI,EGFDE
HJJBF: DBGAD
BCCCF: EGFDE,EJHAE
CFEJI: GFJBG
GIGJB: HJJBF
BBEGC: BDDIF
IICJI: BDEAF,BDEAF,BDEAF,BDEAF
IICJI IICJI IICJI IICJI IICJI IICJI IICJI IICJI IICJI IICJI IICJI IICJI IICJI IICJI IICJI IICJI IICJI IICJI IICJI IICJI IICJI IICJI IICJI IICJI IICJI IICJI IICJI IICJI IICJI IICJI IICJI IICJI IICJI IICJI IICJI IICJI IICJI IICJI IICJI IICJI IICJI IICJI IICJI IICJI IICJI IICJI IICJI IICJI IICJI IICJI 
AAAAA BHCHI HAJAC JBIIB HHBIE AAIGH JDBCE BHICD EGAJG EIDAI CFFIH EFBGG EICIF CEJAE GCJFA CGIEH GFDEI FHAEA FFHAB AIBEH JIGIA FDHHB CDHCA GCJFA CGIEH GFDEI BJJIJ EIFCE GDAJC BIGIF DGCAF IFAAH JFEFB CECJH HJDFD EICIF BEJBH CEJAE GCJFA CGIEH GFDEI JDHFG HACEE EDDHE AAGDD ADHII GDFGG AJJAJ CBCHC ADCAE HDHCH
EDDHE: AAGDD
JDBCE: BHICD
JIGIA: FDHHB
CBCHC: ADCAE
ADHII: GDFGG
EFBGG: EICIF
JFEFB: CECJH
BHCHI: HAJAC
FFHAB: AIBEH
JBIIB: HHBIE
CDHCA: GCJFA
HACEE: EDDHE
CEJAE: GCJFA,GCJFA
CEJAE CEJAE CEJAE CEJAE CEJAE CEJAE CEJAE CEJAE CEJAE CEJAE CEJAE CEJAE CEJAE CEJAE CEJAE CEJAE CEJAE CEJAE CEJAE CEJAE CEJAE CEJAE CEJAE CEJAE CEJAE CEJAE CEJAE CEJAE CEJAE CEJAE CEJAE CEJAE CEJAE CEJAE CEJAE CEJAE CEJAE CEJAE CEJAE CEJAE CEJAE CEJAE CEJAE CEJAE CEJAE CEJAE CEJAE CEJAE CEJAE CEJAE 
AAAAA ABBGD IDFHH EBEJA DIBFB EFFHI DBFHG DHJHG BAEFF EBBGF HAJCD FHGED BHBBH AFGIA BFICD CEIBJ CABBA CCEJJ DDCIE DBFHG JHCFE BBBFE ADFJC EBBGF HAJCD FGGBG EFDCJ GEIJH CHAIE GGIDB AHGAA EHEAJ HGCHG GJFHF DDCIE CIGFI BBBFE BIFIA BAEFF EBBGF HAJCD CABAD AFEIG IAADE EAFED CICDI ICDCF DIABJ CFAJE EJIIB AFDJD
FGGBG: EFDCJ
IAADE: EAFED
EAFED: CICDI
CABBA: CCEJJ
BBBFE: ADFJC,BIFIA
GGIDB: AHGAA
DDCIE: DBFHG,CIGFI
EHEAJ: HGCHG
CIGFI: BBBFE
BFICD: CEIBJ
CFAJE: EJIIB
AHGAA: EHEAJ
AFEIG: IAADE
DIBFB: EFFHI
BIFIA: BAEFF
JHCFE: BBBFE
AAAAA: ABBGD
EJIIB: AFDJD
AFGIA: BFICD
CABAD: AFEIG
DHJHG: BAEFF
EFDCJ: GEIJH
HGCHG: GJFHF
GJFHF: DDCIE
CICDI: ICDCF
FHGED: BHBBH
CEIBJ: CABBA
BHBBH: AFGIA
CHAIE: GGIDB
GEIJH: CHAIE
DBFHG: DHJHG,JHCFE
DIABJ: CFAJE
ADFJC: EBBGF
AFDJD: 
EBBGF: HAJCD,HAJCD,HAJCD
EBBGF EBBGF EBBGF EBBGF EBBGF EBBGF EBBGF EBBGF EBBGF EBBGF EBBGF EBBGF EBBGF EBBGF EBBGF EBBGF EBBGF EBBGF EBBGF EBBGF EBBGF EBBGF EBBGF EBBGF EBBGF EBBGF EBBGF EBBGF EBBGF EBBGF EBBGF EBBGF EBBGF EBBGF EBBGF EBBGF EBBGF EBBGF EBBGF EBBGF EBBGF EBBGF EBBGF EBBGF EBBGF EBBGF EBBGF EBBGF EBBGF EBBGF 
AAAAA GGIHF IJBCI BCJEF DCEIF BDFHJ IHCEB FAHIC CAIDH GCGBD DCEIF BDFHJ DADDC CCFFI JGBCH ECDAA DJGDD FJAJG CHJFI BCJEF GCGBD DCEIF BDFHJ JDAAE BHFDC IAJHE GDICH BDFEI DIACD FFIFH DFEIF GJGIG DBFBC HJHIE ICBCI GCDFC DGHBC GHGIH CAEGA GHHBC DCEIF BDFHJ DEDFE BHEFD EACCH EGIHF CHJFI BCJEF DCEIF BDFHJ FAJAI
ICBCI: GCDFC
CCFFI: JGBCH
BDFHJ: IHCEB,DADDC,JDAAE,DEDFE,FAJAI
DADDC: CCFFI
GHHBC: DCEIF
IAJHE: GDICH
FFIFH: DFEIF
GCGBD: DCEIF,DCEIF
GCGBD GCGBD GCGBD GCGBD GCGBD GCGBD GCGBD GCGBD GCGBD GCGBD GCGBD GCGBD GCGBD GCGBD GCGBD GCGBD GCGBD GCGBD GCGBD GCGBD GCGBD GCGBD GCGBD GCGBD GCGBD GCGBD GCGBD GCGBD GCGBD GCGBD GCGBD GCGBD GCGBD GCGBD GCGBD GCGBD GCGBD GCGBD GCGBD GCGBD GCGBD GCGBD GCGBD GCGBD GCGBD GCGBD GCGBD GCGBD GCGBD GCGBD 
AAAAA HHCDI DDDHG HEHAI IAJAC HHDCA ADGIJ BIBII DJEGJ AGJGA AGIBF ICEFD GAJFH BCEGF AEJCE HFAGB BDECE EGEAH HHDCA ADGIJ JEIJB FCHEI BBBDB JDEFD EGEAH HHDCA ADGIJ DHDDD IIIHE AEFDF BAFAG EEFGB IJCEJ FCGIE CBDCD FIJAI BGFHB BDECE HHDCA ADGIJ BHAJD CEGCJ JCDIH IEFEA FHCFB EHAGG GGHFG GJJCA EGEAH HHDCA ADGIJ
AGIBF: ICEFD
JCDIH: IEFEA
FCHEI: BBBDB
BGFHB: BDECE
EGEAH: HHDCA,HHDCA,HHDCA
EGEAH EGEAH EGEAH EGEAH EGEAH EGEAH EGEAH EGEAH EGEAH EGEAH EGEAH EGEAH EGEAH EGEAH EGEAH EGEAH EGEAH EGEAH EGEAH EGEAH EGEAH EGEAH EGEAH EGEAH EGEAH EGEAH EGEAH EGEAH EGEAH EGEAH EGEAH EGEAH EGEAH EGEAH EGEAH EGEAH EGEAH EGEAH EGEAH EGEAH EGEAH EGEAH EGEAH EGEAH EGEAH EGEAH EGEAH EGEAH EGEAH EGEAH 
AAAAA EEBJI CDHFH BHFCG ADDFG AHFFE GJAIH JCDBF HCIGF DFFHC DFBFF JDBDG ABDIA BJFFF EAGAG BJDIA FAEIF IGDIF DFFHC GEFBG JDBDG ABDIA ACDCE FFJEF FIEDA ABDFE FEDHF AIFIE GDHBD IGEBE FDHBH FHBGJ JDCDJ HEFGH JIGDB HBIEH JDBDG ABDIA IDEHD HBCDI JHCFJ EGDEB IJFBG HCHJI JJBDE ICJIE FECJE ECDEF DEIBB AIFEI HECAH
HECAH: 
JDCDJ: HEFGH
GDHBD: IGEBE
EEBJI: CDHFH
JDBDG: ABDIA,ABDIA,ABDIA
JDBDG JDBDG JDBDG JDBDG JDBDG JDBDG JDBDG JDBDG JDBDG JDBDG JDBDG JDBDG JDBDG JDBDG JDBDG JDBDG JDBDG JDBDG JDBDG JDBDG JDBDG JDBDG JDBDG JDBDG JDBDG JDBDG JDBDG JDBDG JDBDG JDBDG JDBDG JDBDG JDBDG JDBDG JDBDG JDBDG JDBDG JDBDG JDBDG JDBDG JDBDG JDBDG JDBDG JDBDG JDBDG JDBDG JDBDG JDBDG JDBDG JDBDG 
AAAAA FFCFJ EFGCF GCDCF JBCEC BCDFB JJIFI ACIHE CCEHG EDEAA AFIFF BDIAB AFJDJ JAAGA JEIDE GHJIE FDJIJ GCFBC CIECI GGABE EJEDB EDIFF GJEJA CJFBA HIAHH GJEEB JEIDE GHJIE HGGBD DDFCJ FFCIE IHCAA JEJGA ADFFG JECAI IJEFE BEHGF JEIDE GHJIE HEGGG EAFCF EHBHH GEIEB BDDFI IIGAC DDCJI IJEIE BEHCG FJEBJ HFAIA EJEFB
GCFBC: CIECI
IJEIE: BEHCG
EAFCF: EHBHH
BDIAB: AFJDJ
JEIDE: GHJIE,GHJIE,GHJIE
JEIDE JEIDE JEIDE JEIDE JEIDE JEIDE JEIDE JEIDE JEIDE JEIDE JEIDE JEIDE JEIDE JEIDE JEIDE JEIDE JEIDE JEIDE JEIDE JEIDE JEIDE JEIDE JEIDE JEIDE JEIDE JEIDE JEIDE JEIDE JEIDE JEIDE JEIDE JEIDE JEIDE JEIDE JEIDE JEIDE JEIDE JEIDE JEIDE JEIDE JEIDE JEIDE JEIDE JEIDE JEIDE JEIDE JEIDE JEIDE JEIDE JEIDE 
AAAAA DADDH EEDHH FJJDC EBIIA GEHIE FCGFF EBAFJ GBJEG DAFAB BCBGJ BFFFF FCDEB IHHBB AECCG JADGJ IHCDF AEEDG BIIIG GDJDE AICEC HCFGD DAEGD AEGIA CDEFC ADCHC GAJCG DAFAB FCDEB IHHBB JDEEJ AECCG JADGJ HEJIH HFHCI EBJCD FEGAH FEDCH ECACF ECIGD JAFAJ GACEJ GCIFH FCDEB AECCG JADGJ CHIFD IDDFF FHBBD BCHFB DIFFB
GAJCG: DAFAB
AICEC: HCFGD
HCFGD: DAEGD
AECCG: JADGJ,JADGJ,JADGJ
AECCG AECCG AECCG AECCG AECCG AECCG AECCG AECCG AECCG AECCG AECCG AECCG AECCG AECCG AECCG AECCG AECCG AECCG AECCG AECCG AECCG AECCG AECCG AECCG AECCG AECCG AECCG AECCG AECCG AECCG AECCG AECCG AECCG AECCG AECCG AECCG AECCG AECCG AECCG AECCG AECCG AECCG AECCG AECCG AECCG AECCG AECCG AECCG AECCG AECCG 
AAAAA AGBFE GEGJB IJHIE GDEGC GFCDI IJJJD EJEJI GFCIE EJJDD FFAFJ GCGGC FCDCE BDJCA GDEJA EDEFB FBEGJ JEBHB FBHCF IDHGC AAHJC GDBCI CJAAB FCDIG CDECE GFCIE EJJDD FFAFJ BCJHA HFJDB DIDJE DEDAG HBBBB AGJCA CEIFG BJICI GFCDI JGIJA DJAFC GFCIE EJJDD FFAFJ BFBJI BGFDJ HACAG FDFAE AGDJI JGJJC GIGJC GBFAE CDECE
AGDJI: JGJJC
IJHIE: GDEGC
BCJHA: HFJDB
IJJJD: EJEJI
IDHGC: AAHJC
FCDCE: BDJCA
GFCDI: IJJJD,JGIJA
HACAG: FDFAE
HBBBB: AGJCA
JEBHB: FBHCF
BFBJI: BGFDJ
AGBFE: GEGJB
EDEFB: FBEGJ
EJJDD: FFAFJ,FFAFJ,FFAFJ
EJJDD EJJDD EJJDD EJJDD EJJDD EJJDD EJJDD EJJDD EJJDD EJJDD EJJDD EJJDD EJJDD EJJDD EJJDD EJJDD EJJDD EJJDD EJJDD EJJDD EJJDD EJJDD EJJDD EJJDD EJJDD EJJDD EJJDD EJJDD EJJDD EJJDD EJJDD EJJDD EJJDD EJJDD EJJDD EJJDD EJJDD EJJDD EJJDD EJJDD EJJDD EJJDD EJJDD EJJDD EJJDD EJJDD EJJDD EJJDD EJJDD EJJDD 
AAAAA BJJDG JBCFC BECBB EJHDA EEADH CCHAE IEIIC CEFIG CDJED HEIBB BEJDA DJBJB CEDJD FCDDG CFAGF HJIFG JGEEG FJHCF FJAHD EHDFB HCAFJ FFIHF BEJDA FEJHH DBFIG ECJFH CEDJD FCDDG BIFEH HFJHG EAGHF EHEGH GDIJJ IEFJG EGCDE DBECE GJJII ECJFH CEDJD FCDDG IGAFG ACGGH GECJI HDACJ HJFBG DFHIJ FIIFD EIEAJ ABFAA JGHCA
HDACJ: HJFBG
HFJHG: EAGHF
DBFIG: ECJFH
DFHIJ: FIIFD
ACGGH: GECJI
HEIBB: BEJDA
BJJDG: JBCFC
CFAGF: HJIFG
CCHAE: IEIIC
EHEGH: GDIJJ
FJAHD: EHDFB
HJIFG: JGEEG
FJHCF: FJAHD
IEFJG: EGCDE
BEJDA: DJBJB,FEJHH
CEDJD: FCDDG,FCDDG,FCDDG
CEDJD CEDJD CEDJD CEDJD CEDJD CEDJD CEDJD CEDJD CEDJD CEDJD CEDJD CEDJD CEDJD CEDJD CEDJD CEDJD CEDJD CEDJD CEDJD CEDJD CEDJD CEDJD CEDJD CEDJD CEDJD CEDJD CEDJD CEDJD CEDJD CEDJD CEDJD CEDJD CEDJD CEDJD CEDJD CEDJD CEDJD CEDJD CEDJD CEDJD CEDJD CEDJD CEDJD CEDJD CEDJD CEDJD CEDJD CEDJD CEDJD CEDJD 
AAAAA GAGCD AAEDD EFAJB EIAHF AFEBD HHHAA JGGJD DCAEC AHCIJ IGFJC BGIAJ FEJFG HGDIB JJGIA JFJGF DBJEH JEGCG EEIJE FFBBG CGADI FGIJC GCFGJ FEJFG HGDIB JBHHB ADGIH BJGAG HDJDG AAHHH AHBCC BAIBD DJJCB FBEHG AABBD CFGIG EHGEH BGIAJ GCFGJ FEJFG HGDIB FGHEG HIDCD BDJCG HCDJA DHIFE IFBAG DDGDJ HDGGI HECEG CAAIF
HDGGI: HECEG
HIDCD: BDJCG
EEIJE: FFBBG
HGDIB: JJGIA,JBHHB,FGHEG
JBHHB: ADGIH
BAIBD: DJJCB
EIAHF: AFEBD
AABBD: CFGIG
AFEBD: HHHAA
CAAIF: 
FGHEG: HIDCD
AAHHH: AHBCC
AAAAA: GAGCD
EFAJB: EIAHF
HHHAA: JGGJD
EHGEH: BGIAJ
FGIJC: GCFGJ
DHIFE: IFBAG
DCAEC: AHCIJ
GCFGJ: FEJFG,FEJFG
GCFGJ GCFGJ GCFGJ GCFGJ GCFGJ GCFGJ GCFGJ GCFGJ GCFGJ GCFGJ GCFGJ GCFGJ GCFGJ GCFGJ GCFGJ GCFGJ GCFGJ GCFGJ GCFGJ GCFGJ GCFGJ GCFGJ GCFGJ GCFGJ GCFGJ GCFGJ GCFGJ GCFGJ GCFGJ GCFGJ GCFGJ GCFGJ GCFGJ GCFGJ GCFGJ GCFGJ GCFGJ GCFGJ GCFGJ GCFGJ GCFGJ GCFGJ GCFGJ GCFGJ GCFGJ GCFGJ GCFGJ GCFGJ GCFGJ GCFGJ 
AAAAA EJBAJ GCBDJ FDAAJ AAEHF CEJAI HAIAE EIJGI EJADA DCDDD CBIEE HHBHI BGCAI AEEJE IHDDE JFEII EGABH IGJAE BDDHE IIJFF EEFJJ HCEJF JBCCD BDIFJ GHGFF IHDDE JFEII EGABH AICEG CJBBB JACIE CBGFH FBEJH JCGHH GCJCG JHFDJ DHEED GHHFB JFGIA BGCAI FBHDJ JFEII EGABH DIAHD FJGDE ICJCE AHICI AICBH BJEDC DEJAD JGDFD
GHHFB: JFGIA
JGDFD: 
IHDDE: JFEII,JFEII
IHDDE IHDDE IHDDE IHDDE IHDDE IHDDE IHDDE IHDDE IHDDE IHDDE IHDDE IHDDE IHDDE IHDDE IHDDE IHDDE IHDDE IHDDE IHDDE IHDDE IHDDE IHDDE IHDDE IHDDE IHDDE IHDDE IHDDE IHDDE IHDDE IHDDE IHDDE IHDDE IHDDE IHDDE IHDDE IHDDE IHDDE IHDDE IHDDE IHDDE IHDDE IHDDE IHDDE IHDDE IHDDE IHDDE IHDDE IHDDE IHDDE IHDDE 
AAAAA DDCAB FEICH HFBDI AHJCA JDBJH EDGJH JGJJH CJHJH IGBAF AABFC EHDJJ FHJFG EDFDD FIJAB GCDCA ECABF HCJHI CJGFA IICCG FIDFI IGBAF DCFEA AABFC EHDJJ FHJFG BCBEC IACCF FHCBI HAFAF BHDEI EHDJJ FHJFG IEBJD CIICA AHEBE BGGFA HJCJA GGFGA ECAHH EIEFC CAFFA GJCHI HEDJE HCGFB IFEBI CJHJH DCFEA EHDJJ FHJFG GAHGD
EIEFC: CAFFA
GGFGA: ECAHH
DCFEA: AABFC,EHDJJ
AHJCA: JDBJH
GCDCA: ECABF
FIJAB: GCDCA
DDCAB: FEICH
CJHJH: IGBAF,DCFEA
AHEBE: BGGFA
HCGFB: IFEBI
AAAAA: DDCAB
BGGFA: HJCJA
FEICH: HFBDI
JDBJH: EDGJH
HJCJA: GGFGA
GAHGD: 
FHCBI: HAFAF
IGBAF: AABFC,DCFEA
BHDEI: EHDJJ
JGJJH: CJHJH
EDGJH: JGJJH
IEBJD: CIICA
FHJFG: EDFDD,BCBEC,IEBJD,GAHGD
IACCF: FHCBI
CIICA: AHEBE
GJCHI: HEDJE
EDFDD: FIJAB
HCJHI: CJGFA
HAFAF: BHDEI
EHDJJ: FHJFG,FHJFG,FHJFG,FHJFG
EHDJJ EHDJJ EHDJJ EHDJJ EHDJJ EHDJJ EHDJJ EHDJJ EHDJJ EHDJJ EHDJJ EHDJJ EHDJJ EHDJJ EHDJJ EHDJJ EHDJJ EHDJJ EHDJJ EHDJJ EHDJJ EHDJJ EHDJJ EHDJJ EHDJJ EHDJJ EHDJJ EHDJJ EHDJJ EHDJJ EHDJJ EHDJJ EHDJJ EHDJJ EHDJJ EHDJJ EHDJJ EHDJJ EHDJJ EHDJJ EHDJJ EHDJJ EHDJJ EHDJJ EHDJJ EHDJJ EHDJJ EHDJJ EHDJJ EHDJJ 
AAAAA AGIGH CJIAE IDDEE EAAEC DFEFJ IEIJH FBHCB IAFAJ FAHAE FBEBD FFAJF AAFJC IBDIA IDEAD CIDIF FHAJJ FCFAD FBHCB BHCJE IAFAJ FAHAE DJAEH JDJJE IHFGH CIDBF DDIFJ CCGAB CFGAC GDGEE BHCJE IAFAJ FAHAE DCDGA DFDJC EDEJE GAJCH JJFCF JHAAI ICDAD IDHGI FCFAD FBHCB IAFAJ FAHAE IAECF JCFFB IHEHF IGCDC IAHFD FHAJJ
JDJJE: IHFGH
FAHAE: FBEBD,DJAEH,DCDGA,IAECF
FFAJF: AAFJC
EAAEC: DFEFJ
IDDEE: EAAEC
FHAJJ: FCFAD
IAFAJ: FAHAE,FAHAE,FAHAE,FAHAE
FAHAE IAFAJ IAFAJ IAFAJ IAFAJ IAFAJ IAFAJ IAFAJ IAFAJ IAFAJ IAFAJ IAFAJ IAFAJ IAFAJ IAFAJ IAFAJ IAFAJ IAFAJ IAFAJ IAFAJ IAFAJ IAFAJ IAFAJ IAFAJ IAFAJ IAFAJ IAFAJ IAFAJ IAFAJ IAFAJ IAFAJ IAFAJ IAFAJ IAFAJ IAFAJ IAFAJ IAFAJ IAFAJ IAFAJ IAFAJ IAFAJ IAFAJ IAFAJ IAFAJ IAFAJ IAFAJ IAFAJ IAFAJ IAFAJ IAFAJ 
AAAAA EBBFG HIIFF JAFJJ GJJEF FCECC JJECG AFCGG GFGAD DJBED AHFFJ CHHGD BCGED IJGEI BJEAG IHDII ABIEI FCECC JFHJC JHIAG HIIGG HJBAA GFGAD DJBED AHFFJ CAIFD EFIDF JFHFG JAGAC EJGDJ ADEGI DGBJH CAEAF ACHHC HCBJI GFJCD IAAJI AFCGG DJBED AHFFJ EFAIB FADBB IJGJC IFFHH EDGGE CCDFD EBEDC AAEIB CIHHI EGAFI ABBCH
GFJCD: IAAJI
JFHFG: JAGAC
JAGAC: EJGDJ
CIHHI: EGAFI
EFIDF: JFHFG
EFAIB: FADBB
ABIEI: FCECC
IHDII: ABIEI
EBBFG: HIIFF
BJEAG: IHDII
ADEGI: DGBJH
EBEDC: AAEIB
AAAAA: EBBFG
GFGAD: DJBED,DJBED
GFGAD GFGAD GFGAD GFGAD GFGAD GFGAD GFGAD GFGAD GFGAD GFGAD GFGAD GFGAD GFGAD GFGAD GFGAD GFGAD GFGAD GFGAD GFGAD GFGAD GFGAD GFGAD GFGAD GFGAD GFGAD GFGAD GFGAD GFGAD GFGAD GFGAD GFGAD GFGAD GFGAD GFGAD GFGAD GFGAD GFGAD GFGAD GFGAD GFGAD GFGAD GFGAD GFGAD GFGAD GFGAD GFGAD GFGAD GFGAD GFGAD GFGAD 
AAAAA ECJDI CEBGD BAADI IGAJF GEHIJ CGHBI FBADH IIDFI ECCDC BDCHG HJEHA JIJAD AJJGA HHHHB JJAIH HFCEE CFJIB FDGEG EIJDJ HBAJG CCAEA HGBEE DGBBA CGHBI IIDFI ECCDC FJIEG GICAG JCEEI HBHCJ JHFJD FJGDC AAAED GFDGC EAIBD CCDHH BGGHA EGFBA IIDFI ECCDC GCAGE FDHDB JEIDF JIBJB DJDCF HGGII ADDJF IIDFI ECCDC EHHCG
EGFBA: IIDFI
HGGII: ADDJF
DGBBA: CGHBI
HHHHB: JJAIH
CFJIB: FDGEG
CGHBI: FBADH,IIDFI
GICAG: JCEEI
AAAED: GFDGC
JJAIH: HFCEE
EIJDJ: HBAJG
HBHCJ: JHFJD
EHHCG: 
AAAAA: ECJDI
EAIBD: CCDHH
FJIEG: GICAG
JIBJB: DJDCF
CEBGD: BAADI
BDCHG: HJEHA
JIJAD: AJJGA
IGAJF: GEHIJ
FJGDC: AAAED
JCEEI: HBHCJ
HFCEE: CFJIB
JEIDF: JIBJB
AJJGA: HHHHB
GFDGC: EAIBD
ADDJF: IIDFI
FDHDB: JEIDF
GEHIJ: CGHBI
JHFJD: FJGDC
FBADH: IIDFI
HJEHA: JIJAD
ECJDI: CEBGD
FDGEG: EIJDJ
HBAJG: CCAEA
CCAEA: HGBEE
IIDFI: ECCDC,ECCDC,ECCDC,ECCDC
IIDFI IIDFI IIDFI IIDFI IIDFI IIDFI IIDFI IIDFI IIDFI IIDFI IIDFI IIDFI IIDFI IIDFI IIDFI IIDFI IIDFI IIDFI IIDFI IIDFI IIDFI IIDFI IIDFI IIDFI IIDFI IIDFI IIDFI IIDFI IIDFI IIDFI IIDFI IIDFI IIDFI IIDFI IIDFI IIDFI IIDFI IIDFI IIDFI IIDFI IIDFI IIDFI IIDFI IIDFI IIDFI IIDFI IIDFI IIDFI IIDFI IIDFI 
AAAAA GIEGG IGCAC BHJDF CHAAC FCJDF JFIAI BEDBC BJEJE BHADF DDGFD GJBJG EGIAA FFIFH DBFFE CCFDH AIFEE GDBJI JHJFA HIJGE JGJCC EHBAB FBEGF EGIAA FFIFH EDHGA EIDJB GABFE IABJI EDBIE IFDHG CIHFA EGIAA FFIFH DHDEH CCJCB DIFFB JEBCI EHGAI EBAGJ GFFAD GHIFB FDFII DGBHG FGJGA EGIAA FFIFH CGIDG GHHGF HHIGF DJBDE
IGCAC: BHJDF
JEBCI: EHGAI
CIHFA: EGIAA
JHJFA: HIJGE
GABFE: IABJI
GIEGG: IGCAC
EHGAI: EBAGJ
CGIDG: GHHGF
DHDEH: CCJCB
GJBJG: EGIAA
FCJDF: JFIAI
HHIGF: DJBDE
FFIFH: DBFFE,EDHGA,DHDEH,CGIDG
AIFEE: GDBJI
HIJGE: JGJCC
GHHGF: HHIGF
AAAAA: GIEGG
BHADF: DDGFD
GHIFB: FDFII
CCJCB: DIFFB
GDBJI: JHJFA
BJEJE: BHADF
BHJDF: CHAAC
DDGFD: GJBJG
FGJGA: EGIAA
CCFDH: AIFEE
EHBAB: FBEGF
JFIAI: BEDBC
EIDJB: GABFE
EGIAA: FFIFH,FFIFH,FFIFH,FFIFH
EGIAA EGIAA EGIAA EGIAA EGIAA EGIAA EGIAA EGIAA EGIAA EGIAA EGIAA EGIAA EGIAA EGIAA EGIAA EGIAA EGIAA EGIAA EGIAA EGIAA EGIAA EGIAA EGIAA EGIAA EGIAA EGIAA EGIAA EGIAA EGIAA EGIAA EGIAA EGIAA EGIAA EGIAA EGIAA EGIAA EGIAA EGIAA EGIAA EGIAA EGIAA EGIAA EGIAA EGIAA EGIAA EGIAA EGIAA EGIAA EGIAA EGIAA 
AAAAA CIJFH GIDID BDIBE BDFIH DAAGE JHHGE HHGJC GIGEE GIAFH CEADE CGJFA IADCE EIJHJ CEGEB HBFEF IBBCG BCBCA EHDCC DGBHB BDEGF JHHGE AHDFH GGFIE BJDGA GIAFH CEADE HAIHH HHCEA EBCHB IACAD IEBCE HIJHF DCHGD JCCDE DCECJ GGFIE GIAFH CEADE CAADC EEJBB FAIAH EEFEI JDAHG EAIJI AIEEH GIGEE GIAFH CEADE CCBFH BFIJH
IACAD: IEBCE
CIJFH: GIDID
BDEGF: JHHGE
HBFEF: IBBCG
CGJFA: IADCE
IADCE: EIJHJ
JDAHG: EAIJI
GIDID: BDIBE
DGBHB: BDEGF
BDFIH: DAAGE
CEADE: CGJFA,HAIHH,CAADC,CCBFH
EEFEI: JDAHG
FAIAH: EEFEI
AAAAA: CIJFH
HHGJC: GIGEE
IEBCE: HIJHF
DCECJ: GGFIE
GIGEE: GIAFH,GIAFH
GIGEE GIGEE GIGEE GIGEE GIGEE GIGEE GIGEE GIGEE GIGEE GIGEE GIGEE GIGEE GIGEE GIGEE GIGEE GIGEE GIGEE GIGEE GIGEE GIGEE GIGEE GIGEE GIGEE GIGEE GIGEE GIGEE GIGEE GIGEE GIGEE GIGEE GIGEE GIGEE GIGEE GIGEE GIGEE GIGEE GIGEE GIGEE GIGEE GIGEE GIGEE GIGEE GIGEE GIGEE GIGEE GIGEE GIGEE GIGEE GIGEE GIGEE 
AAAAA EJBFC GHBGH FCDIG GFGDB ECEFB CAFDJ FEBAD GAAGC AHEHJ HIFJA BEEJF FFIED EFHJA CJAEG IDFBD HGHFD BABAD ADIIG IFBEF EAAFB GAAGC AHEHJ IAIGE IGEIF EECAE FAJGG IDEGD DAFCB IFBEF HAGFF GAAGC AHEHJ FFCHA EBIEF BJJBE CAGBC DFCGJ CCECB HHDAB HAGCG AJBHA GAAGC AHEHJ EGAGF CFEEH HHAAI FAEAA CCFAD GCDHD JDBAJ
CCECB: HHDAB
EAAFB: GAAGC
HHDAB: HAGCG
EJBFC: GHBGH
IGEIF: EECAE
DFCGJ: CCECB
JDBAJ: 
FFIED: EFHJA
HAGCG: AJBHA
GFGDB: ECEFB
CJAEG: IDFBD
AAAAA: EJBFC
IFBEF: EAAFB,HAGFF
FEBAD: GAAGC
HGHFD: BABAD
FAEAA: CCFAD
DAFCB: IFBEF
FCDIG: GFGDB
BJJBE: CAGBC
IAIGE: IGEIF
CAGBC: DFCGJ
CFEEH: HHAAI
HAGFF: GAAGC
IDFBD: HGHFD
FFCHA: EBIEF
EFHJA: CJAEG
AHEHJ: HIFJA,IAIGE,FFCHA,EGAGF
BABAD: ADIIG
GHBGH: FCDIG
EBIEF: BJJBE
EECAE: FAJGG
CCFAD: GCDHD
HIFJA: BEEJF
BEEJF: FFIED
GCDHD: JDBAJ
ECEFB: CAFDJ
EGAGF: CFEEH
HHAAI: FAEAA
CAFDJ: FEBAD
IDEGD: DAFCB
ADIIG: IFBEF
GAAGC: AHEHJ,AHEHJ,AHEHJ,AHEHJ
GAAGC GAAGC GAAGC GAAGC GAAGC GAAGC GAAGC GAAGC GAAGC GAAGC GAAGC GAAGC GAAGC GAAGC GAAGC GAAGC GAAGC GAAGC GAAGC GAAGC GAAGC GAAGC GAAGC GAAGC GAAGC GAAGC GAAGC GAAGC GAAGC GAAGC GAAGC GAAGC GAAGC GAAGC GAAGC GAAGC GAAGC GAAGC GAAGC GAAGC GAAGC GAAGC GAAGC GAAGC GAAGC GAAGC GAAGC GAAGC GAAGC GAAGC 
AAAAA AJCBJ JIFJA ABGIF FIGIE GBAID FJBFI AEFGI IEIHJ IBAHA HBDJJ ICJFI BHDGH ABCIF EEFJE DBDFG IADEA GIJJB ECDEH HCIFJ HIABJ JIJCB FJJDG FJBFI JFIAB AEFGI IEIHJ EIHHB FJDJI HFCDJ HCGIH HBEBE BJCHG GABGA FJBFI JFIAB AEFGI IEIHJ GDAAI JHHCA EGIDH BEFFG DCDHA CDFDB JBFFE GCHEE JFICH GBGBF IAAGH FJBFI AEFGI
IADEA: GIJJB
ECDEH: HCIFJ
GABGA: FJBFI
AJCBJ: JIFJA
HCIFJ: HIABJ
JFIAB: AEFGI,AEFGI
JFIAB JFIAB JFIAB JFIAB JFIAB JFIAB JFIAB JFIAB JFIAB JFIAB JFIAB JFIAB JFIAB JFIAB JFIAB JFIAB JFIAB JFIAB JFIAB JFIAB JFIAB JFIAB JFIAB JFIAB JFIAB JFIAB JFIAB JFIAB JFIAB JFIAB JFIAB JFIAB JFIAB JFIAB JFIAB JFIAB JFIAB JFIAB JFIAB JFIAB JFIAB JFIAB JFIAB JFIAB JFIAB JFIAB JFIAB JFIAB JFIAB JFIAB 
AAAAA BEJBI BHIJD IJGGD GGBGB ICGIH FDIGI JJAHE BHEAG HAJGJ DBIAI AFGEA FBDIJ HADDA BHAAD DGDHD DDCJC FBFGA IDJCC GHDDI BHEAG DBIAI AFGEA DHFGE CEBBF HDDDJ EEADA HGEIJ FFIHF DEIFH FGDJA BFHFE HAJGJ DBIAI AFGEA ACJEI BADIG FAFHE IICIE IJABJ JIEBF HGAGI JHGGJ HAJGJ DBIAI AFGEA DHGBD AIEAA JCCBH CHDDF JAJGF
BADIG: FAFHE
HDDDJ: EEADA
JCCBH: CHDDF
AIEAA: JCCBH
DBIAI: AFGEA,AFGEA,AFGEA,AFGEA
DBIAI DBIAI DBIAI DBIAI DBIAI DBIAI DBIAI DBIAI DBIAI DBIAI DBIAI DBIAI DBIAI DBIAI DBIAI DBIAI DBIAI DBIAI DBIAI DBIAI DBIAI DBIAI DBIAI DBIAI DBIAI DBIAI DBIAI DBIAI DBIAI DBIAI DBIAI DBIAI DBIAI DBIAI DBIAI DBIAI DBIAI DBIAI DBIAI DBIAI DBIAI DBIAI DBIAI DBIAI DBIAI DBIAI DBIAI DBIAI DBIAI DBIAI 
AAAAA BEEIJ AIEAD GJFJF IBGGA CCGBA EIHFA HIBAG HGJHE HBBIC CIAIA EIHII BHCHG JBAHH HCJHD JIDEA JGJDH DBEBB BHFHF DAHCD JHEDA CIAIA EIHII BHCHG JAHJJ BCBAH AABBG IEGCC GHJHH JJFHG GCBBG IDCGA CIAIA EIHII BHCHG HJAJG EAGED GICGJ GFJED GGFIC DEEHG FAIDD IHAFB BBJCE CIAIA EIHII BHCHG EAJBF IBGJA DEIDJ DCDED
BEEIJ: AIEAD
EAJBF: IBGJA
IBGGA: CCGBA
DCDED: 
EAGED: GICGJ
HJAJG: EAGED
IDCGA: CIAIA
GGFIC: DEEHG
DEIDJ: DCDED
JBAHH: HCJHD
IBGJA: DEIDJ
AAAAA: BEEIJ
GICGJ: GFJED
HIBAG: HGJHE
BHCHG: JBAHH,JAHJJ,HJAJG,EAJBF
FAIDD: IHAFB
GCBBG: IDCGA
CIAIA: EIHII,EIHII,EIHII,EIHII
CIAIA CIAIA CIAIA CIAIA CIAIA CIAIA CIAIA CIAIA CIAIA CIAIA CIAIA CIAIA CIAIA CIAIA CIAIA CIAIA CIAIA CIAIA CIAIA CIAIA CIAIA CIAIA CIAIA CIAIA CIAIA CIAIA CIAIA CIAIA CIAIA CIAIA CIAIA CIAIA CIAIA CIAIA CIAIA CIAIA CIAIA CIAIA CIAIA CIAIA CIAIA CIAIA CIAIA CIAIA CIAIA CIAIA CIAIA CIAIA CIAIA CIAIA 
AAAAA GADCA CFAAI GGBBD IBCFE ABEGI BDBJH FGGAE IBBFJ GCAFE CFJJE JJIGE HEBJA BCBBH BAHAE HEDFE AAFFB HBGFE JBADC FHBDJ BDBJH GCAFE CCCDI IDHDC CFJJE JJIGE CHJHD IJJAD JDAJD CGAFE BIBHH JDECD EIAIE AIGIC ICHGF IDHDC CFJJE JJIGE HCDEE JABJA FHBDC EDEGA DFDBD BCGBC JGBCF ABJII EIBBI GCAFE CFJJE JJIGE HICDE
AAFFB: HBGFE
CFJJE: JJIGE,JJIGE,JJIGE,JJIGE
CFJJE CFJJE CFJJE CFJJE CFJJE CFJJE CFJJE CFJJE CFJJE CFJJE CFJJE CFJJE CFJJE CFJJE CFJJE CFJJE CFJJE CFJJE CFJJE CFJJE CFJJE CFJJE CFJJE CFJJE CFJJE CFJJE CFJJE CFJJE CFJJE CFJJE CFJJE CFJJE CFJJE CFJJE CFJJE CFJJE CFJJE CFJJE CFJJE CFJJE CFJJE CFJJE CFJJE CFJJE CFJJE CFJJE CFJJE CFJJE CFJJE CFJJE 
AAAAA HFIFH EDGCH DGHGF IHGHB GAAAI IFHFD AECJJ IDCAB EDAED HJJGH CAAAG HHCGJ BFFCG GCEGA DEBIE GCJJC IIFFA IDCAB EDAED BBABF DCJAF GGCIB AJABE CEEGB HBCEF DJBCJ IDBCA EAHFG IFJAH IIFFA IDCAB EDAED BEGIH ICGII AHIFD GAAAI FDHCH JIGBD FCHHI AECJJ IIFFA IDCAB EDAED EBFCJ FIEGC BIDDC JGAFE DAHFF FJJFD HIFHF
FCHHI: AECJJ
HHCGJ: BFFCG
EDGCH: DGHGF
DEBIE: GCJJC
CEEGB: HBCEF
DAHFF: FJJFD
IDCAB: EDAED,EDAED,EDAED,EDAED
IDCAB IDCAB IDCAB IDCAB IDCAB IDCAB IDCAB IDCAB IDCAB IDCAB IDCAB IDCAB IDCAB IDCAB IDCAB IDCAB IDCAB IDCAB IDCAB IDCAB IDCAB IDCAB IDCAB IDCAB IDCAB IDCAB IDCAB IDCAB IDCAB IDCAB IDCAB IDCAB IDCAB IDCAB IDCAB IDCAB IDCAB IDCAB IDCAB IDCAB IDCAB IDCAB IDCAB IDCAB IDCAB IDCAB IDCAB IDCAB IDCAB IDCAB 
AAAAA BCDBC GDGFE GDHHA CDHAF JGJJG FJHJC EDACH CJHGH HJFAI GIAHC IACEI CIGFB DGFGA FGHCB HEBEC JCFCH IIGCE ADJIJ ADJED AIFBA BFCEG GGIHD CIGFB DGFGA EGFHC ACEAE JJIDC FCJFG EBACE HEHDB DEEII EBIBF CJJJC CIGFB DGFGA CCJJE IIABC BIAJC AEJDI JJAJJ GIEIH ICAHC BCIDG EGIHC GGIHD CIGFB DGFGA BFFFC GHJFA HCCAJ
EDACH: CJHGH
HEHDB: DEEII
JCFCH: IIGCE
IACEI: CIGFB
GDHHA: CDHAF
GIAHC: IACEI
FCJFG: EBACE
BFCEG: GGIHD
HEBEC: JCFCH
CJJJC: CIGFB
AIFBA: BFCEG
HCCAJ: 
EBACE: HEHDB
AAAAA: BCDBC
EBIBF: CJJJC
BFFFC: GHJFA
FJHJC: EDACH
FGHCB: HEBEC
IIGCE: ADJIJ
DEEII: EBIBF
ADJED: AIFBA
BCIDG: EGIHC
ADJIJ: ADJED
GDGFE: GDHHA
ACEAE: JJIDC
ICAHC: BCIDG
DGFGA: FGHCB,EGFHC,CCJJE,BFFFC
EGFHC: ACEAE
CDHAF: JGJJG
AEJDI: JJAJJ
BIAJC: AEJDI
BCDBC: GDGFE
JJIDC: FCJFG
CJHGH: HJFAI
EGIHC: GGIHD
JGJJG: FJHJC
GIEIH: ICAHC
GHJFA: HCCAJ
CCJJE: IIABC
GGIHD: CIGFB,CIGFB
GGIHD GGIHD GGIHD GGIHD GGIHD GGIHD GGIHD GGIHD GGIHD GGIHD GGIHD GGIHD GGIHD GGIHD GGIHD GGIHD GGIHD GGIHD GGIHD GGIHD GGIHD GGIHD GGIHD GGIHD GGIHD GGIHD GGIHD GGIHD GGIHD GGIHD GGIHD GGIHD GGIHD GGIHD GGIHD GGIHD GGIHD GGIHD GGIHD GGIHD GGIHD GGIHD GGIHD GGIHD GGIHD GGIHD GGIHD GGIHD GGIHD GGIHD 
AAAAA GJCAE JJDCA CFDHD AHCEB JCGJA FBJCA DCGGF FJFGA AHBHC EJFFD IDIJH JIDBB ACGGB HHBHC GBHJJ GHGHI CEJFE GJCAJ FBJCA JACAF EJFFD GJCJE IDIJH JIDBB GIICD GGDIJ HHCJI BACCG IGBGH CIDID DEACE HHJBG HGGCH AHBHC HBHBE GJCJE IDIJH JIDBB BICAI BCBFE FAFJH HJECA IDHEC DEJGA BAJIG EFCIA HGFGG BFIJH IIGGE AHBHC
IIGGE: AHBHC
GJCJE: IDIJH,IDIJH
GJCJE GJCJE GJCJE GJCJE GJCJE GJCJE GJCJE GJCJE GJCJE GJCJE GJCJE GJCJE GJCJE GJCJE GJCJE GJCJE GJCJE GJCJE GJCJE GJCJE GJCJE GJCJE GJCJE GJCJE GJCJE GJCJE GJCJE GJCJE GJCJE GJCJE GJCJE GJCJE GJCJE GJCJE GJCJE GJCJE GJCJE GJCJE GJCJE GJCJE GJCJE GJCJE GJCJE GJCJE GJCJE GJCJE GJCJE GJCJE GJCJE GJCJE 
AAAAA FCJGF AACFE GCICD BBCHE JHFCF BHJAI DBCEG GFHAC CBJAJ HFFBJ AADFG FHBAI AICFA JDAHJ DDBBD JFGBB HJIBD FGGAI JEFDE DBHHD DBCEG JGCBF IABBH FHBAI AICFA CIGDC DAAIG EIIFG DFHBA FJCIE AJDJE HFHFA ADHIH DCFAG AADFG FHBAI AICFA IHBCI HHJJF AACHJ CDDAD EDIFE AGGCE EBJBD DCJBB DBHHD IEIBA FJCIE JGCBF HFFBJ
CDDAD: EDIFE
AACHJ: CDDAD
ADHIH: DCFAG
CBJAJ: HFFBJ
GCICD: BBCHE
JEFDE: DBHHD
FCJGF: AACFE
DAAIG: EIIFG
FJCIE: AJDJE,JGCBF
AADFG: FHBAI,FHBAI
AADFG AADFG AADFG AADFG AADFG AADFG AADFG AADFG AADFG AADFG AADFG AADFG AADFG AADFG AADFG AADFG AADFG AADFG AADFG AADFG AADFG AADFG AADFG AADFG AADFG AADFG AADFG AADFG AADFG AADFG AADFG AADFG AADFG AADFG AADFG AADFG AADFG AADFG AADFG AADFG AADFG AADFG AADFG AADFG AADFG AADFG AADFG AADFG AADFG AADFG 
AAAAA JAEIA HIBFF AJHBF GAGAF EBEAF BBCEC DJEEA IDCCI EDFIF BEEGI GFAAA DBGAE CAEIH BAGHG BCGHB JHGHJ IIACH CBFBC JHCCD IDACI AEFBB EDGDC BJGCB JEJAA BECJJ CAEIH BAGHG BCGHB FIBDE GDJGA DECGB DDHED IFBFH GEGID DBGAE CAEIH BAGHG BCGHB JCIHH GDDHI EIDFI FEHIA CGAEH IIIFD AHBIB IEHCJ AEJAI HGGGC EDFIF BAJEA
EIDFI: FEHIA
GFAAA: DBGAE
BAJEA: 
JAEIA: HIBFF
BJGCB: JEJAA
IDCCI: EDFIF
BECJJ: CAEIH
GDDHI: EIDFI
IEHCJ: AEJAI
GDJGA: DECGB
IIIFD: AHBIB
HGGGC: EDFIF
AAAAA: JAEIA
CAEIH: BAGHG,BAGHG,BAGHG
CAEIH CAEIH CAEIH CAEIH CAEIH CAEIH CAEIH CAEIH CAEIH CAEIH CAEIH CAEIH CAEIH CAEIH CAEIH CAEIH CAEIH CAEIH CAEIH CAEIH CAEIH CAEIH CAEIH CAEIH CAEIH CAEIH CAEIH CAEIH CAEIH CAEIH CAEIH CAEIH CAEIH CAEIH CAEIH CAEIH CAEIH CAEIH CAEIH CAEIH CAEIH CAEIH CAEIH CAEIH CAEIH CAEIH CAEIH CAEIH CAEIH CAEIH 
AAAAA JEICF IGICH HCFAF AFEAD EBAFH JAHHI HJEFC EDEEA IIIDD JCJCE EAJBF EFHJI DFDFB GEDEF AJIHJ ABCEA AJHBJ BIFFH BHDDJ CFJFD AEJJE EDEEA HCGBB DCJEI JCJCE EFHJI DFDFB JAJHG FDGBD FBGCD AEBIF HDBHG EAJJC EAJBF EFHJI DFDFB EGHJG BIHFG CAEJA BJFJD JAJCG BDCGH HGJDA AEJJE CFIGF ICDHH FEBFI JABHH EAJBF EFHJI
AJIHJ: ABCEA
CFIGF: ICDHH
JAHHI: HJEFC
DFDFB: GEDEF,JAJHG,EGHJG
JABHH: EAJBF
EAJBF: EFHJI,EFHJI,EFHJI
EAJBF EAJBF EAJBF EAJBF EAJBF EAJBF EAJBF EAJBF EAJBF EAJBF EAJBF EAJBF EAJBF EAJBF EAJBF EAJBF EAJBF EAJBF EAJBF EAJBF EAJBF EAJBF EAJBF EAJBF EAJBF EAJBF EAJBF EAJBF EAJBF EAJBF EAJBF EAJBF EAJBF EAJBF EAJBF EAJBF EAJBF EAJBF EAJBF EAJBF EAJBF EAJBF EAJBF EAJBF EAJBF EAJBF EAJBF EAJBF EAJBF EAJBF 
AAAAA FGCIE GCHFH GJIJF IBEDI CFCBH FDAIC AAEHA HBCGC EHACG AHHAD BJBDG GDCHF CDJBH GHBGC CAEHG ADIGG JBBAA IGCFI BBGDJ EFIFI HBCGC EHACG EBGAA IBACE FIFDD IEIGI EDEAG BIEDI DFGCC ICFJB JGFFJ DJFHG CGJDI EADAE FBIGH HBCGC EHACG IDCJA ICJAH HGDHD JEAJF ECHAG GHHGD EGIAB JIJDF JIFHC AAJHD CBEHE BBGJG GBFFG
IGCFI: BBGDJ
DJFHG: CGJDI
EDEAG: BIEDI
ECHAG: GHHGD
CGJDI: EADAE
CBEHE: BBGJG
HGDHD: JEAJF
AAEHA: HBCGC
ICFJB: JGFFJ
CAEHG: ADIGG
EBGAA: IBACE
AAJHD: CBEHE
FBIGH: HBCGC
EADAE: FBIGH
FGCIE: GCHFH
EFIFI: HBCGC
AAAAA: FGCIE
FIFDD: IEIGI
CFCBH: FDAIC
ICJAH: HGDHD
BBGDJ: EFIFI
EGIAB: JIJDF
AHHAD: BJBDG
GHHGD: EGIAB
GCHFH: GJIJF
ADIGG: JBBAA
IDCJA: ICJAH
FDAIC: AAEHA
JIFHC: AAJHD
GHBGC: CAEHG
BBGJG: GBFFG
BJBDG: GDCHF
IEIGI: EDEAG
DFGCC: ICFJB
JEAJF: ECHAG
EHACG: AHHAD,EBGAA,IDCJA
JGFFJ: DJFHG
IBEDI: CFCBH
JBBAA: IGCFI
JIJDF: JIFHC
BIEDI: DFGCC
GJIJF: IBEDI
HBCGC: EHACG,EHACG,EHACG
EHACG HBCGC HBCGC HBCGC HBCGC HBCGC HBCGC HBCGC HBCGC HBCGC HBCGC HBCGC HBCGC HBCGC HBCGC HBCGC HBCGC HBCGC HBCGC HBCGC HBCGC HBCGC HBCGC HBCGC HBCGC HBCGC HBCGC HBCGC HBCGC HBCGC HBCGC HBCGC HBCGC HBCGC HBCGC HBCGC HBCGC HBCGC HBCGC HBCGC HBCGC HBCGC HBCGC HBCGC HBCGC HBCGC HBCGC HBCGC HBCGC HBCGC 
AAAAA IIGBD GCEHE DFFJG JAJFF GJIFA AIIHH IHDEC BCJDG FFFAC CIGHJ IHJDC HAEGI CFGAE DJGFI IAAEJ GGFIF HJIAB DAEED AEFCI AECBI DFGFI EFHHE GABJC BBHIE FBCAD HADCI IHJDC HAEGI HFGII CIDIG FDIBJ CEIII HGJHJ JHEDA DHEIA IECCD HADCI IHJDC HAEGI DIDBG CBJHG BHDCE ABBJF EBIBG HHDDF ICJDJ HGCCB CJCED CIGHJ CCGJE
DFGFI: EFHHE
HGJHJ: JHEDA
DHEIA: IECCD
BCJDG: FFFAC
CJCED: CIGHJ
AEFCI: AECBI
CFGAE: DJGFI
ABBJF: EBIBG
BBHIE: FBCAD
HFGII: CIDIG
EFHHE: GABJC
FBCAD: HADCI
JAJFF: GJIFA
HAEGI: CFGAE,HFGII,DIDBG
DIDBG: CBJHG
CCGJE: 
AAAAA: IIGBD
DJGFI: IAAEJ
IHDEC: BCJDG
GJIFA: AIIHH
AECBI: DFGFI
IAAEJ: GGFIF
HHDDF: ICJDJ
HGCCB: CJCED
GABJC: BBHIE
IIGBD: GCEHE
HADCI: IHJDC,IHJDC
HADCI HADCI HADCI HADCI HADCI HADCI HADCI HADCI HADCI HADCI HADCI HADCI HADCI HADCI HADCI HADCI HADCI HADCI HADCI HADCI HADCI HADCI HADCI HADCI HADCI HADCI HADCI HADCI HADCI HADCI HADCI HADCI HADCI HADCI HADCI HADCI HADCI HADCI HADCI HADCI HADCI HADCI HADCI HADCI HADCI HADCI HADCI HADCI HADCI HADCI 
AAAAA IFJFE AHIDI CIECC HAGHG HAGFA EBHHF AEIDC BCIFF HEIIB DCHHC DJCEJ FDBCH FGCJA HCGEI BEIGJ DDAEF AIJEE FBFAF GICGH AHCCE JEACC BJDGH BHGGJ DJCEJ FDBCH IFCCB CEECJ BAAJH AJJGJ IJIGD BGJJG GFIFF EEHCD BHGGJ DJCEJ FDBCH GBDII FAGGF AIGIF FIFAC EAHFC GDBGH FCBJB FIJIC EBAJF DJCEJ FDBCH DFADJ CDADA IHFCD
EBAJF: DJCEJ
BAAJH: AJJGJ
HAGFA: EBHHF
DDAEF: AIJEE
AEIDC: BCIFF
FCBJB: FIJIC
FIJIC: EBAJF
DJCEJ: FDBCH,FDBCH,FDBCH,FDBCH
DJCEJ DJCEJ DJCEJ DJCEJ DJCEJ DJCEJ DJCEJ DJCEJ DJCEJ DJCEJ DJCEJ DJCEJ DJCEJ DJCEJ DJCEJ DJCEJ DJCEJ DJCEJ DJCEJ DJCEJ DJCEJ DJCEJ DJCEJ DJCEJ DJCEJ DJCEJ DJCEJ DJCEJ DJCEJ DJCEJ DJCEJ DJCEJ DJCEJ DJCEJ DJCEJ DJCEJ DJCEJ DJCEJ DJCEJ DJCEJ DJCEJ DJCEJ DJCEJ DJCEJ DJCEJ DJCEJ DJCEJ DJCEJ DJCEJ DJCEJ 
AAAAA GCGEH EBHDD DDBDB EBIHH AJEBH IADBD CJDGH GABBB FHCGE FEBJG FCIBG HHAGC IDEIB GIEBA DABGB DIFJH CIIIC CCHGF IBHFJ JDGJD JFEAI CJFJE ICGBI FCIBG HHAGC HEFEI DGBFJ BBEDD HGDFA CGDJD IBFDF CGCJG FEBJG FCIBG HHAGC GEAGI GCFDD EBBAD IGECD CIHCC EJHJB JFCAJ IDJEB FCIBG HHAGC JEACH JCHGI JFGBI IEACH JAGIG
EJHJB: JFCAJ
JFCAJ: IDJEB
HEFEI: DGBFJ
GCGEH: EBHDD
IDEIB: GIEBA
GIEBA: DABGB
JCHGI: JFGBI
DABGB: DIFJH
JDGJD: JFEAI
GEAGI: GCFDD
JEACH: JCHGI
CJFJE: ICGBI
HGDFA: CGDJD
AAAAA: GCGEH
AJEBH: IADBD
BBEDD: HGDFA
GABBB: FHCGE
EBBAD: IGECD
IEACH: JAGIG
CGCJG: FEBJG
EBIHH: AJEBH
FEBJG: FCIBG,FCIBG
FEBJG FEBJG FEBJG FEBJG FEBJG FEBJG FEBJG FEBJG FEBJG FEBJG FEBJG FEBJG FEBJG FEBJG FEBJG FEBJG FEBJG FEBJG FEBJG FEBJG FEBJG FEBJG FEBJG FEBJG FEBJG FEBJG FEBJG FEBJG FEBJG FEBJG FEBJG FEBJG FEBJG FEBJG FEBJG FEBJG FEBJG FEBJG FEBJG FEBJG FEBJG FEBJG FEBJG FEBJG FEBJG FEBJG FEBJG FEBJG FEBJG FEBJG 
AAAAA EEDBC AHCCH JGCIE ICAHF GHADF EEJJA GHDBC HABBI ADHJE DICDD ACCEC CFDBF HHJAF HBBAJ JABFD FHGHE ABBJG JFGJF BDBDF JEEBE AIBHH ACCEC GJAEA CFDBF HHJAF IAEGI FCCDE EIAEJ CFBFD CDHCI BJEID CJIJA ADBIH FAHAJ GFCBH JEAGA FCFFI CEDCC JCCFC FAIDB DICDD ACCEC CFDBF HHJAF EBGDH ICCFD JCCBA AHEIE IAHIC GCBDH
JFGJF: BDBDF
JABFD: FHGHE
IAEGI: FCCDE
CDHCI: BJEID
CJIJA: ADBIH
EIAEJ: CFBFD
CFBFD: CDHCI
DICDD: ACCEC,ACCEC
DICDD DICDD DICDD DICDD DICDD DICDD DICDD DICDD DICDD DICDD DICDD DICDD DICDD DICDD DICDD DICDD DICDD DICDD DICDD DICDD DICDD DICDD DICDD DICDD DICDD DICDD DICDD DICDD DICDD DICDD DICDD DICDD DICDD DICDD DICDD DICDD DICDD DICDD DICDD DICDD DICDD DICDD DICDD DICDD DICDD DICDD DICDD DICDD DICDD DICDD 
AAAAA BDAFD GFDHH HBEGC FIHHF EJAHD BDACH IEFIG AAJAH JADEF BEJFJ FACDD CBDHC GCBCG EGFGG BEJFJ FACDD AAADJ EIBJA HEGBJ AHFIJ IADDJ FEGAH EJHAE BDJJI AAJAH JADEF AFIIA BEJFJ FACDD JEJHH IEDFA FCHAD ACIJF DJBAC HCHIB DFIAJ HGGED AFGBI HIDBD AAJAH JADEF AFIIA BEJFJ FACDD AIBBH GBEFD JEIFC BIHGF CBFGA IIEDE
FIHHF: EJAHD
IEFIG: AAJAH
FCHAD: ACIJF
DJBAC: HCHIB
AAJAH: JADEF,JADEF,JADEF
AAJAH AAJAH AAJAH AAJAH AAJAH AAJAH AAJAH AAJAH AAJAH AAJAH AAJAH AAJAH AAJAH AAJAH AAJAH AAJAH AAJAH AAJAH AAJAH AAJAH AAJAH AAJAH AAJAH AAJAH AAJAH AAJAH AAJAH AAJAH AAJAH AAJAH AAJAH AAJAH AAJAH AAJAH AAJAH AAJAH AAJAH AAJAH AAJAH AAJAH AAJAH AAJAH AAJAH AAJAH AAJAH AAJAH AAJAH AAJAH AAJAH AAJAH 
AAAAA GHIHJ BEABF JHJIG GJBDD HAJJI DDFJA BCJFC AAEAH BHHJG CJAHG EAAGB IEJHB AIFCE FHECB GHCCB HAEHG CHEAA ABEEH CDFJG BBFDA EHFAI DECDF CJAHG BAGEI EAAGB IEJHB DCEDI IBABJ DHIFC FCHAJ GJGFG GHBBI IAGIA DEECF IEFAC BJIIA EAAGB IEJHB IJIIA EBEBJ DHDDH FFBJI DHCJG GAFBA DGDGB CBDEB FABFC BHHJG CJAHG BAGEI
HAJJI: DDFJA
DDFJA: BCJFC
DHIFC: FCHAJ
CBDEB: FABFC
CDFJG: BBFDA
FABFC: BHHJG
DGDGB: CBDEB
HAEHG: CHEAA
DECDF: CJAHG
GAFBA: DGDGB
BCJFC: AAEAH
IEJHB: AIFCE,DCEDI,IJIIA
EHFAI: DECDF
GHCCB: HAEHG
DCEDI: IBABJ
BJIIA: EAAGB
AIFCE: FHECB
BEABF: JHJIG
AAAAA: GHIHJ
EAAGB: IEJHB,IEJHB,IEJHB
IEJHB EAAGB EAAGB EAAGB EAAGB EAAGB EAAGB EAAGB EAAGB EAAGB EAAGB EAAGB EAAGB EAAGB EAAGB EAAGB EAAGB EAAGB EAAGB EAAGB EAAGB EAAGB EAAGB EAAGB EAAGB EAAGB EAAGB EAAGB EAAGB EAAGB EAAGB EAAGB EAAGB EAAGB EAAGB EAAGB EAAGB EAAGB EAAGB EAAGB EAAGB EAAGB EAAGB EAAGB EAAGB EAAGB EAAGB EAAGB EAAGB EAAGB 
AAAAA ICJGE JFICC JCCBB CDFDD BGIGB JDHBB GFIAH IJAFE JEIFB JAFEA FBBJD GJHGB ICFGI JHDEG AFFDJ CEAJD CAGFC AJADA JBBIC DIJAG DBIBD DCHFI BFFJI IFHBC DHFCF HFDCJ JABJG JAFEA FBBJD GJHGB ABHHI IAIAH IHBBE CGFFF BJHDE EFAED AEIDE EEIFH BBCHG IBHGE DCJIH AGHIC CFIGE JAGJC CHEJG FBBJD GJHGB CDEJB AJHDA CHICE
JAGJC: CHEJG
DCHFI: BFFJI
BGIGB: JDHBB
DIJAG: DBIBD
JAFEA: FBBJD,FBBJD
JAFEA JAFEA JAFEA JAFEA JAFEA JAFEA JAFEA JAFEA JAFEA JAFEA JAFEA JAFEA JAFEA JAFEA JAFEA JAFEA JAFEA JAFEA JAFEA JAFEA JAFEA JAFEA JAFEA JAFEA JAFEA JAFEA JAFEA JAFEA JAFEA JAFEA JAFEA JAFEA JAFEA JAFEA JAFEA JAFEA JAFEA JAFEA JAFEA JAFEA JAFEA JAFEA JAFEA JAFEA JAFEA JAFEA JAFEA JAFEA JAFEA JAFEA 
AAAAA GIJGH JFJEA CJCCB GGHDH AEGIH AGGIJ AEFGB GBEFF FJAGG FGBGB FJFAA HBGHI AGEJC AIJHB DJIAF AEGIH AGGIJ DIGJC GJCEG HBIJE GAEJD AHAEA BGAJB GBBCJ FAHAC EFFDC IJDDH HIAHG DJIAF HBGCG AEGIH AGGIJ BADBD HGHBH DAJGC EJGIF EGIBI GADHI HHGFH AIBEH HDGAG FACGD EAFGF DJIAF AEGIH AGGIJ CBGJF EEGJD HCAJH EDFGB
JFJEA: CJCCB
GBEFF: FJAGG
GJCEG: HBIJE
HGHBH: DAJGC
EDFGB: 
HCAJH: EDFGB
EGIBI: GADHI
BGAJB: GBBCJ
EJGIF: EGIBI
GBBCJ: FAHAC
HBGCG: AEGIH
AHAEA: BGAJB
FAHAC: EFFDC
FACGD: EAFGF
AAAAA: GIJGH
HDGAG: FACGD
GIJGH: JFJEA
AEFGB: GBEFF
AGEJC: AIJHB
FJFAA: HBGHI
IJDDH: HIAHG
AIJHB: DJIAF
GADHI: HHGFH
EAFGF: DJIAF
HIAHG: DJIAF
HBIJE: GAEJD
DIGJC: GJCEG
CBGJF: EEGJD
FJAGG: FGBGB
HBGHI: AGEJC
DJIAF: AEGIH,HBGCG,AEGIH
EEGJD: HCAJH
AEGIH: AGGIJ,AGGIJ,AGGIJ,AGGIJ
AEGIH AEGIH AEGIH AEGIH AEGIH AEGIH AEGIH AEGIH AEGIH AEGIH AEGIH AEGIH AEGIH AEGIH AEGIH AEGIH AEGIH AEGIH AEGIH AEGIH AEGIH AEGIH AEGIH AEGIH AEGIH AEGIH AEGIH AEGIH AEGIH AEGIH AEGIH AEGIH AEGIH AEGIH AEGIH AEGIH AEGIH AEGIH AEGIH AEGIH AEGIH AEGIH AEGIH AEGIH AEGIH AEGIH AEGIH AEGIH AEGIH AEGIH 
AAAAA EAIHH EJEHG BIEAJ CHAJE GABAI DAHBA JBIEF JHEFI FDFJI JBAFC FCHEE CEGBG EEBDB EFFDD HFDIF EBJDE HBAEB GAICJ JBIEF JHEFI GFEHD BCABI GADFA GADIF HFFJH IEAIE BICGG HGJGF ABCFB JBIEF JHEFI CBJJB JJEJJ IJDJJ JEHDB FGHDF JEGHE DJCJH BGDFI HBAEB GAICJ JBIEF JHEFI BCJJF JHAEC ICFAB FDIGA EDBHE GBBEG EFGBE
CEGBG: EEBDB
BCABI: GADFA
FGHDF: JEGHE
ICFAB: FDIGA
HFDIF: EBJDE
JHEFI: FDFJI,GFEHD,CBJJB,BCJJF
EDBHE: GBBEG
IJDJJ: JEHDB
CBJJB: JJEJJ
AAAAA: EAIHH
JEGHE: DJCJH
EEBDB: EFFDD
BGDFI: HBAEB
FDIGA: EDBHE
BIEAJ: CHAJE
HFFJH: IEAIE
BCJJF: JHAEC
GAICJ: JBIEF,JBIEF
GAICJ GAICJ GAICJ GAICJ GAICJ GAICJ GAICJ GAICJ GAICJ GAICJ GAICJ GAICJ GAICJ GAICJ GAICJ GAICJ GAICJ GAICJ GAICJ GAICJ GAICJ GAICJ GAICJ GAICJ GAICJ GAICJ GAICJ GAICJ GAICJ GAICJ GAICJ GAICJ GAICJ GAICJ GAICJ GAICJ GAICJ GAICJ GAICJ GAICJ GAICJ GAICJ GAICJ GAICJ GAICJ GAICJ GAICJ GAICJ GAICJ GAICJ 
AAAAA AFEDA JEAGA DGJBC JAJHI EGCDH IGIEE FBJDG ADDIH ABJJJ DJJHA GEAFC AGFCI CHAIA FABHI EGGEJ FIAHF HGEHH GBFDF HEGAE CDDHI DHFIE FJFBI CHAIA FABHI DBEGC AIHJF HBFFJ GDGFA DCHAB DJJHA AEBEE FJFBI CHAIA FABHI GFJEC HDIIG IICCI GCCBA JCIII HIDDB GAHFJ FFGJG CJCFI AHHII IIGJD AEBEE AGFCI CHAIA FABHI FABGE
AHHII: IIGJD
DBEGC: AIHJF
CDDHI: DHFIE
JAJHI: EGCDH
AGFCI: CHAIA,CHAIA
AGFCI AGFCI AGFCI AGFCI AGFCI AGFCI AGFCI AGFCI AGFCI AGFCI AGFCI AGFCI AGFCI AGFCI AGFCI AGFCI AGFCI AGFCI AGFCI AGFCI AGFCI AGFCI AGFCI AGFCI AGFCI AGFCI AGFCI AGFCI AGFCI AGFCI AGFCI AGFCI AGFCI AGFCI AGFCI AGFCI AGFCI AGFCI AGFCI AGFCI AGFCI AGFCI AGFCI AGFCI AGFCI AGFCI AGFCI AGFCI AGFCI AGFCI 
AAAAA DBHEG AADEA IAABC CHFCF HFIAI FGDJB JFGAD CAGIC HCIJJ GJIAF EDAHF GFJEH CDIBJ EBGCF JCIDF IDJFG DFDGC ABIIF CCBEB AGGEI HFIAI FGDJB JFGAD AJDDF HDEDC DDCHG EHJIB EHADG FABJA ACEEH DBECE FIHJH AFGAD IGABJ BHDGA FGDJB JFGAD IDAED GBDCF DCIBA ACGBJ IHCBD IHAII HBGBI EHBAJ FGDJB JFGAD EAICH ACEAB CEAJH
DCIBA: ACGBJ
DDCHG: EHJIB
FIHJH: AFGAD
CHFCF: HFIAI
BHDGA: FGDJB
IDAED: GBDCF
HFIAI: FGDJB,FGDJB
HFIAI FGDJB HFIAI FGDJB HFIAI FGDJB HFIAI FGDJB HFIAI FGDJB HFIAI FGDJB HFIAI FGDJB HFIAI FGDJB HFIAI FGDJB HFIAI FGDJB HFIAI FGDJB HFIAI FGDJB HFIAI FGDJB HFIAI FGDJB HFIAI FGDJB HFIAI FGDJB HFIAI FGDJB HFIAI FGDJB HFIAI FGDJB HFIAI FGDJB HFIAI FGDJB HFIAI FGDJB HFIAI FGDJB HFIAI FGDJB HFIAI FGDJB 
AAAAA HCADI GFGBB HJBCI FEFCD FFAGI EBEFC AEHJH CCAAA GDCDA DJCJH GIAEA JIJII HBEEI DHEHJ CDGIB CABEI BFGJI BHFFH CFEDI AEAHA HBJFD GJCHG IGIBF AFGIB HBGGI DHEHJ CDGIB FGCGH FEADA JFFAH BFDIJ JDHIB DJADD FDJBF AFGIB DGDEJ JIJII HBEEI DHEHJ CDGIB DJEFF HJFCG GIBJC JICBJ EHBGF HAFJI ICEEA HFDGG CCAGH FFDJH
GJCHG: IGIBF
BFDIJ: JDHIB
HCADI: GFGBB
FEFCD: FFAGI
FDJBF: AFGIB
HAFJI: ICEEA
HJBCI: FEFCD
DGDEJ: JIJII
GFGBB: HJBCI
IGIBF: AFGIB
GDCDA: DJCJH
CDGIB: CABEI,FGCGH,DJEFF
DJCJH: GIAEA
FFDJH: 
ICEEA: HFDGG
BHFFH: CFEDI
FFAGI: EBEFC
JDHIB: DJADD
HBEEI: DHEHJ,DHEHJ
HBEEI DHEHJ HBEEI HBEEI HBEEI DHEHJ HBEEI HBEEI HBEEI DHEHJ HBEEI DHEHJ HBEEI DHEHJ HBEEI HBEEI DHEHJ HBEEI HBEEI DHEHJ HBEEI DHEHJ HBEEI DHEHJ HBEEI HBEEI HBEEI HBEEI DHEHJ HBEEI DHEHJ HBEEI DHEHJ HBEEI DHEHJ HBEEI DHEHJ HBEEI HBEEI DHEHJ HBEEI HBEEI DHEHJ HBEEI HBEEI DHEHJ HBEEI HBEEI HBEEI HBEEI 
AAAAA HGFBH BIECC CJFAJ CEEJG EIIEJ IHCEB FGFAG CDEBA DFJBH ABFHA GBJGG HIGDJ EIDED JABBD JBIJD FAIDI AJHHD EBECA GJIEB DHBEG DFJBH GBJGG HIGDJ CEAIH IAJIF FCABB ABGJE EHCHC IGFEA DFJBH ABFHA HADFI GBJGG HIGDJ EBABE DAEDC EBCFA HIABC GGAHI HGFCA FAACB HADCI ADBEG CJHJE IBEBC DEJDA HADFI GBJGG HIGDJ IIJIA
ABGJE: EHCHC
DHBEG: DFJBH
EHCHC: IGFEA
HADCI: ADBEG
FGFAG: CDEBA
CJFAJ: CEEJG
DEJDA: HADFI
ABFHA: GBJGG,HADFI
HGFCA: FAACB
EIDED: JABBD
ADBEG: CJHJE
AJHHD: EBECA
GBJGG: HIGDJ,HIGDJ,HIGDJ,HIGDJ
GBJGG HIGDJ GBJGG HIGDJ GBJGG HIGDJ GBJGG HIGDJ GBJGG HIGDJ GBJGG HIGDJ GBJGG HIGDJ GBJGG HIGDJ GBJGG HIGDJ GBJGG HIGDJ GBJGG HIGDJ GBJGG HIGDJ GBJGG HIGDJ GBJGG HIGDJ GBJGG HIGDJ GBJGG HIGDJ GBJGG HIGDJ GBJGG HIGDJ GBJGG HIGDJ GBJGG HIGDJ GBJGG HIGDJ GBJGG HIGDJ GBJGG HIGDJ GBJGG HIGDJ GBJGG HIGDJ 
AAAAA DAHDE FDJFJ EJAGI AJGBI BACFB DBIJE ADEBH BHIBI EDEFG IEDIJ ABEIJ CDCIB CGGEJ EFFFH BDJHB HEDHG FICDB JJCHG IAAFF CIGJE IHIDA AEGCI CJICJ HHJCI EFFFH BDJHB EAJJE BFDIF BEEEI BBFBH JHAFD EBCIG BFEAI EIHFD CCEIJ BAIGJ ICGDE HHJCI IEDCD EFFFH BDJHB JJFDF JEBBF HEDBI JAEHG HBDCH HIBHH AHHBC CCEBI IDDHA
CJICJ: HHJCI
ADEBH: BHIBI
CIGJE: IHIDA
JHAFD: EBCIG
BACFB: DBIJE
IEDIJ: ABEIJ
BBFBH: JHAFD
AHHBC: CCEBI
FDJFJ: EJAGI
JEBBF: HEDBI
IHIDA: AEGCI
HHJCI: EFFFH,IEDCD
BAIGJ: ICGDE
AJGBI: BACFB
EJAGI: AJGBI
EDEFG: IEDIJ
JJFDF: JEBBF
HEDBI: JAEHG
HIBHH: AHHBC
AAAAA: DAHDE
CDCIB: CGGEJ
BFEAI: EIHFD
DAHDE: FDJFJ
HEDHG: FICDB
IEDCD: EFFFH
JJCHG: IAAFF
AEGCI: CJICJ
JAEHG: HBDCH
BEEEI: BBFBH
BHIBI: EDEFG
FICDB: JJCHG
DBIJE: ADEBH
EIHFD: CCEIJ
EFFFH: BDJHB,BDJHB,BDJHB
EFFFH BDJHB EFFFH BDJHB EFFFH BDJHB EFFFH BDJHB EFFFH BDJHB EFFFH BDJHB EFFFH BDJHB EFFFH BDJHB EFFFH BDJHB EFFFH BDJHB EFFFH BDJHB EFFFH BDJHB EFFFH BDJHB EFFFH BDJHB EFFFH BDJHB EFFFH BDJHB EFFFH BDJHB EFFFH BDJHB EFFFH BDJHB EFFFH BDJHB EFFFH BDJHB EFFFH BDJHB EFFFH BDJHB EFFFH BDJHB EFFFH BDJHB 
AAAAA BICJG GCAJB JGADC FICFF AACFG DDGAG EHCFE BBBIC FIJCG BHBID HBHFC EBFJI HHFHF EABJA BAHAI EHIJI DJHHJ CHBGJ DFJBJ CEHDB IBACE HHHAF AJJGC HGEIJ IBHFF EABJA BAHAI BJGGD BEIJJ JBFBA IGCJI BCIHG DBAEC CCBHD JABAD FIEED DAHHB EBFJI IBHFF HHFHF EABJA BAHAI JACCC GIJFC CDHEJ GHGCG HHCBG CJJHC CHJFA BAHJD
HHFHF: EABJA,EABJA
HHFHF HHFHF HHFHF HHFHF EABJA HHFHF EABJA HHFHF HHFHF EABJA HHFHF EABJA HHFHF HHFHF EABJA HHFHF EABJA HHFHF EABJA HHFHF HHFHF HHFHF HHFHF HHFHF HHFHF HHFHF EABJA HHFHF EABJA HHFHF EABJA HHFHF EABJA HHFHF EABJA HHFHF HHFHF HHFHF HHFHF HHFHF HHFHF EABJA HHFHF HHFHF HHFHF EABJA HHFHF EABJA HHFHF HHFHF 
AAAAA FHHAA CJCFA GBFJA ACFGJ ABBFI GHGBI DJBAE GBJBH GIECG JFJJC IDEIE GJAIH CHBID ADHDA GBJBH GIECG HJIDC GDIGE JJDFB BHBHA CCGBF DCJEG CHBID ADHDA GBJBH GIECG BEABH HBHJI IDDGB IGCBA HGBHH CDHHC BHHBJ FIFDD JBCDG CGFBC CHBID GBJBH GIECG FDHFJ GAAIH BGEJJ JFAJD HFFDG AGAFF HEEDC BGBFG EDFAI ABFEI GBJBH
ADHDA: GBJBH,GBJBH
ADHDA GBJBH ADHDA GBJBH ADHDA GBJBH ADHDA GBJBH ADHDA GBJBH ADHDA GBJBH ADHDA GBJBH ADHDA GBJBH ADHDA GBJBH ADHDA GBJBH ADHDA GBJBH ADHDA GBJBH ADHDA GBJBH ADHDA GBJBH ADHDA GBJBH ADHDA GBJBH ADHDA GBJBH ADHDA GBJBH ADHDA GBJBH ADHDA GBJBH ADHDA GBJBH ADHDA GBJBH ADHDA GBJBH ADHDA GBJBH ADHDA GBJBH 
AAAAA FEJHD DBCHH BEHJC CIIAH CJAID CBAGG BFIJF AHFHD GCJEJ AEDIB EEGHH DEFHG ADHEG HJAGJ HEIBA IJBIB GAFJC IIFBA JGJAI HGIHI GCJEJ AEDIB GDBHB HAJDH ADJGI AGAIE IECFA BIHBI CBIFD JBHAA AHFHD GCJEJ AEDIB GHDDD IGAIB FJGDI AEDAH FDJGH GDHFA EDGFA CEHCG EGGFF BGBAC IFIFC HIICA GCJEJ AEDIB GCAGI BBDGG BEHIB
DBCHH: BEHJC
HJAGJ: HEIBA
AEDAH: FDJGH
FDJGH: GDHFA
GAFJC: IIFBA
HIICA: GCJEJ
BEHJC: CIIAH
ADJGI: AGAIE
IFIFC: HIICA
GCAGI: BBDGG
JBHAA: AHFHD
IJBIB: GAFJC
HEIBA: IJBIB
CBAGG: BFIJF
GHDDD: IGAIB
BEHIB: 
BBDGG: BEHIB
AHFHD: GCJEJ,GCJEJ
AHFHD GCJEJ AHFHD GCJEJ AHFHD GCJEJ AHFHD GCJEJ AHFHD GCJEJ AHFHD GCJEJ AHFHD GCJEJ AHFHD GCJEJ AHFHD GCJEJ AHFHD GCJEJ AHFHD GCJEJ AHFHD GCJEJ AHFHD GCJEJ AHFHD GCJEJ AHFHD GCJEJ AHFHD GCJEJ AHFHD GCJEJ AHFHD GCJEJ AHFHD GCJEJ AHFHD GCJEJ AHFHD GCJEJ AHFHD GCJEJ AHFHD GCJEJ AHFHD GCJEJ AHFHD GCJEJ 
AAAAA JCDIF GFEBB FDCCF JACIH GFJDA ADHDI AGDJG ABFFG FHFJI EDHGH FEBGJ JGBFH DDIHA IFBBE ACBBF EDEEI GACDA FJBFA FGABI IJEEH IJFJF BBIGD DIGHD AJEJH JFDGI BCJCE DCHAI DIEIB BDDIF HEFFC AGHDF EDEEI DJHEG AJBED CHCCJ FGABI IJEEH JEIAI EBACF IGHCG CGCEH HJHAH FCAAI DDHJF BFEFJ FJHGG FJBFA FGABI IJEEH FABIC
JACIH: GFJDA
FHFJI: EDHGH
CGCEH: HJHAH
DIGHD: AJEJH
IJFJF: BBIGD
FEBGJ: JGBFH
EDHGH: FEBGJ
JGBFH: DDIHA
BBIGD: DIGHD
IJEEH: IJFJF,JEIAI,FABIC
BCJCE: DCHAI
FDCCF: JACIH
DDHJF: BFEFJ
DDIHA: IFBBE
FJHGG: FJBFA
FABIC: 
GFJDA: ADHDI
JCDIF: GFEBB
AJBED: CHCCJ
ABFFG: FHFJI
EDEEI: GACDA,DJHEG
AGHDF: EDEEI
FCAAI: DDHJF
IGHCG: CGCEH
ADHDI: AGDJG
DJHEG: AJBED
HEFFC: AGHDF
AGDJG: ABFFG
FJBFA: FGABI,FGABI
FJBFA FJBFA FJBFA FJBFA FGABI FJBFA FJBFA FJBFA FJBFA FGABI FJBFA FJBFA FGABI FJBFA FGABI FJBFA FJBFA FGABI FJBFA FJBFA FJBFA FJBFA FJBFA FJBFA FJBFA FJBFA FJBFA FGABI FJBFA FGABI FJBFA FGABI FJBFA FGABI FJBFA FJBFA FJBFA FJBFA FGABI FJBFA FJBFA FGABI FJBFA FJBFA FGABI FJBFA FJBFA FJBFA FJBFA FJBFA 
AAAAA JGAFG ADCJH HJJEH DHJBI AIDGI EIEAA HDHGB IJJEF DACAA DFDCI FCEJH GFBFC AIGEH DJJCE DBBGD HBIFA IDIFF BGDJA HCCGJ HJDBI CGFDA EGGCG AJEAF FCEJH GFBFC HIIHC IDHJG HGHJI HEAAA GCCBG EAAIG EIIFD DEEJG DACAA DFDCI FCEJH GFBFC BBEGA DIAJG BJDAC AICCH DAHCB BGHEG CAEEG HAJEF AHBJB DDHJA ACBBA EGGCG FCEJH
ADCJH: HJJEH
GFBFC: AIGEH,HIIHC,BBEGA
EIIFD: DEEJG
AICCH: DAHCB
HAJEF: AHBJB
AHBJB: DDHJA
DEEJG: DACAA
FCEJH: GFBFC,GFBFC,GFBFC
GFBFC FCEJH GFBFC FCEJH GFBFC FCEJH GFBFC FCEJH GFBFC FCEJH GFBFC FCEJH GFBFC FCEJH GFBFC FCEJH GFBFC FCEJH GFBFC FCEJH GFBFC FCEJH GFBFC FCEJH GFBFC FCEJH GFBFC FCEJH GFBFC FCEJH GFBFC FCEJH GFBFC FCEJH GFBFC FCEJH GFBFC FCEJH GFBFC FCEJH GFBFC FCEJH GFBFC FCEJH GFBFC FCEJH GFBFC FCEJH GFBFC FCEJH 
AAAAA HDGEA IHCGB JHHJE HEFDC IGICH HFFCF JHEGD GBGHD CJDGB ACEDF AFJHI FBCIE FHHBA BEICF FFHJE EGEBH AJIDI BBIEB AGBED CBIEB HJEIH EJCCB IEGJI JBDFG IEGFI BAJAB EECGE EEDGD EGEBH AJIDI AFBCJ FDEAD BBHAI HCAIH JBFJG CFHJH GDGFI EFFIE JGCAG HAEBI JDICG EACDD FBGAD GICFB FIJAE EAFIA EGEBH AJIDI JEFHD CEICI
IGICH: HFFCF
AGBED: CBIEB
HCAIH: JBFJG
CFHJH: GDGFI
HDGEA: IHCGB
GICFB: FIJAE
CEICI: 
JGCAG: HAEBI
EGEBH: AJIDI,AJIDI,AJIDI
EGEBH AJIDI EGEBH AJIDI EGEBH AJIDI EGEBH AJIDI EGEBH AJIDI EGEBH AJIDI EGEBH AJIDI EGEBH AJIDI EGEBH AJIDI EGEBH AJIDI EGEBH AJIDI EGEBH AJIDI EGEBH AJIDI EGEBH AJIDI EGEBH AJIDI EGEBH AJIDI EGEBH AJIDI EGEBH AJIDI EGEBH AJIDI EGEBH AJIDI EGEBH AJIDI EGEBH AJIDI EGEBH AJIDI EGEBH AJIDI EGEBH AJIDI 
AAAAA BAJJB BBEGC BDDIF AJADD BCCCF EGFDE IICJI BDEAF CCEIH HGHDB BCCJE GFHJF BABEB FIBHC ADGAA CECHA GIGJB HJJBF DBGAD AJADD EJHAE IICJI BDEAF HHCDI CFEJI GFJBG CIHAA DAHID ADCBC CIIBF HHHDG AEEBA AJADD DDACD IICJI BDEAF AACII ICJCA GDCJI IHJFC IGAGC BADHC JICEH GEHIH BCCCF EJHAE EGFDE IICJI BDEAF GGGJA
ADGAA: CECHA
GGGJA: 
GFJBG: CIHAA
BDEAF: CCEIH,HHCDI,AACII,GGGJA
BCCJE: GFHJF
HJJBF: DBGAD
BAJJB: BBEGC
HHCDI: CFEJI
HHHDG: AEEBA
CIIBF: HHHDG
GIGJB: HJJBF
ADCBC: CIIBF
CIHAA: DAHID
ICJCA: GDCJI
GEHIH: BCCCF
AJADD: BCCCF,EJHAE,DDACD
AACII: ICJCA
FIBHC: ADGAA
DDACD: IICJI
BABEB: FIBHC
DAHID: ADCBC
CCEIH: HGHDB
DBGAD: AJADD
IHJFC: IGAGC
IICJI: BDEAF,BDEAF,BDEAF,BDEAF
IICJI BDEAF IICJI BDEAF IICJI BDEAF IICJI BDEAF IICJI BDEAF IICJI BDEAF IICJI BDEAF IICJI BDEAF IICJI BDEAF IICJI BDEAF IICJI BDEAF IICJI BDEAF IICJI BDEAF IICJI BDEAF IICJI BDEAF IICJI BDEAF IICJI BDEAF IICJI BDEAF IICJI BDEAF IICJI BDEAF IICJI BDEAF IICJI BDEAF IICJI BDEAF IICJI BDEAF IICJI BDEAF 
AAAAA BHCHI HAJAC JBIIB HHBIE AAIGH JDBCE BHICD EGAJG EIDAI CFFIH EFBGG EICIF CEJAE GCJFA CGIEH GFDEI FHAEA FFHAB AIBEH JIGIA FDHHB CDHCA GCJFA CGIEH GFDEI BJJIJ EIFCE GDAJC BIGIF DGCAF IFAAH JFEFB CECJH HJDFD EICIF BEJBH CEJAE GCJFA CGIEH GFDEI JDHFG HACEE EDDHE AAGDD ADHII GDFGG AJJAJ CBCHC ADCAE HDHCH
AAGDD: ADHII
JDBCE: BHICD
BHCHI: HAJAC
EFBGG: EICIF
BJJIJ: EIFCE
BEJBH: CEJAE
HHBIE: AAIGH
JIGIA: FDHHB
EDDHE: AAGDD
HACEE: EDDHE
JBIIB: HHBIE
IFAAH: JFEFB
EIFCE: GDAJC
JFEFB: CECJH
GDFGG: AJJAJ
HAJAC: JBIIB
CDHCA: GCJFA
HDHCH: 
FFHAB: AIBEH
CBCHC: ADCAE
AIBEH: JIGIA
HJDFD: EICIF
ADCAE: HDHCH
EGAJG: EIDAI
BHICD: EGAJG
FDHHB: CDHCA
ADHII: GDFGG
CECJH: HJDFD
GFDEI: FHAEA,BJJIJ,JDHFG
GCJFA: CGIEH,CGIEH,CGIEH
GCJFA CGIEH GCJFA CGIEH GCJFA CGIEH GCJFA CGIEH GCJFA CGIEH GCJFA CGIEH GCJFA CGIEH GCJFA CGIEH GCJFA CGIEH GCJFA CGIEH GCJFA CGIEH GCJFA CGIEH GCJFA CGIEH GCJFA CGIEH GCJFA CGIEH GCJFA CGIEH GCJFA CGIEH GCJFA CGIEH GCJFA CGIEH GCJFA CGIEH GCJFA CGIEH GCJFA CGIEH GCJFA CGIEH GCJFA CGIEH GCJFA CGIEH 
AAAAA ABBGD IDFHH EBEJA DIBFB EFFHI DBFHG DHJHG BAEFF EBBGF HAJCD FHGED BHBBH AFGIA BFICD CEIBJ CABBA CCEJJ DDCIE DBFHG JHCFE BBBFE ADFJC EBBGF HAJCD FGGBG EFDCJ GEIJH CHAIE GGIDB AHGAA EHEAJ HGCHG GJFHF DDCIE CIGFI BBBFE BIFIA BAEFF EBBGF HAJCD CABAD AFEIG IAADE EAFED CICDI ICDCF DIABJ CFAJE EJIIB AFDJD
FGGBG: EFDCJ
HAJCD: FHGED,FGGBG,CABAD
CEIBJ: CABBA
EHEAJ: HGCHG
GJFHF: DDCIE
BBBFE: ADFJC,BIFIA
CCEJJ: DDCIE
ABBGD: IDFHH
CFAJE: EJIIB
EFFHI: DBFHG
BFICD: CEIBJ
FHGED: BHBBH
DIBFB: EFFHI
CICDI: ICDCF
IAADE: EAFED
EFDCJ: GEIJH
EBBGF: HAJCD,HAJCD,HAJCD
EBBGF HAJCD EBBGF HAJCD EBBGF HAJCD EBBGF HAJCD EBBGF HAJCD EBBGF HAJCD EBBGF HAJCD EBBGF HAJCD EBBGF HAJCD EBBGF HAJCD EBBGF HAJCD EBBGF HAJCD EBBGF HAJCD EBBGF HAJCD EBBGF HAJCD EBBGF HAJCD EBBGF HAJCD EBBGF HAJCD EBBGF HAJCD EBBGF HAJCD EBBGF HAJCD EBBGF HAJCD EBBGF HAJCD EBBGF HAJCD EBBGF HAJCD 
AAAAA GGIHF IJBCI BCJEF DCEIF BDFHJ IHCEB FAHIC CAIDH GCGBD DCEIF BDFHJ DADDC CCFFI JGBCH ECDAA DJGDD FJAJG CHJFI BCJEF GCGBD DCEIF BDFHJ JDAAE BHFDC IAJHE GDICH BDFEI DIACD FFIFH DFEIF GJGIG DBFBC HJHIE ICBCI GCDFC DGHBC GHGIH CAEGA GHHBC DCEIF BDFHJ DEDFE BHEFD EACCH EGIHF CHJFI BCJEF DCEIF BDFHJ FAJAI
GHGIH: CAEGA
GDICH: BDFEI
DIACD: FFIFH
CAEGA: GHHBC
GCDFC: DGHBC
BCJEF: DCEIF,GCGBD,DCEIF
GHHBC: DCEIF
FJAJG: CHJFI
JGBCH: ECDAA
DBFBC: HJHIE
CHJFI: BCJEF,BCJEF
CHJFI BCJEF CHJFI BCJEF CHJFI BCJEF CHJFI BCJEF CHJFI BCJEF CHJFI BCJEF CHJFI BCJEF CHJFI CHJFI BCJEF CHJFI CHJFI CHJFI CHJFI CHJFI CHJFI CHJFI BCJEF CHJFI BCJEF CHJFI BCJEF CHJFI BCJEF CHJFI BCJEF CHJFI CHJFI CHJFI CHJFI CHJFI CHJFI BCJEF CHJFI CHJFI BCJEF CHJFI CHJFI BCJEF CHJFI CHJFI BCJEF CHJFI 
AAAAA HHCDI DDDHG HEHAI IAJAC HHDCA ADGIJ BIBII DJEGJ AGJGA AGIBF ICEFD GAJFH BCEGF AEJCE HFAGB BDECE EGEAH HHDCA ADGIJ JEIJB FCHEI BBBDB JDEFD EGEAH HHDCA ADGIJ DHDDD IIIHE AEFDF BAFAG EEFGB IJCEJ FCGIE CBDCD FIJAI BGFHB BDECE HHDCA ADGIJ BHAJD CEGCJ JCDIH IEFEA FHCFB EHAGG GGHFG GJJCA EGEAH HHDCA ADGIJ
EGEAH: HHDCA,HHDCA,HHDCA
EGEAH HHDCA EGEAH HHDCA EGEAH HHDCA EGEAH HHDCA EGEAH HHDCA EGEAH HHDCA EGEAH HHDCA EGEAH HHDCA EGEAH HHDCA EGEAH HHDCA EGEAH HHDCA EGEAH HHDCA EGEAH HHDCA EGEAH HHDCA EGEAH HHDCA EGEAH HHDCA EGEAH HHDCA EGEAH HHDCA EGEAH HHDCA EGEAH HHDCA EGEAH HHDCA EGEAH HHDCA EGEAH HHDCA EGEAH HHDCA EGEAH HHDCA 
AAAAA EEBJI CDHFH BHFCG ADDFG AHFFE GJAIH JCDBF HCIGF DFFHC DFBFF JDBDG ABDIA BJFFF EAGAG BJDIA FAEIF IGDIF DFFHC GEFBG JDBDG ABDIA ACDCE FFJEF FIEDA ABDFE FEDHF AIFIE GDHBD IGEBE FDHBH FHBGJ JDCDJ HEFGH JIGDB HBIEH JDBDG ABDIA IDEHD HBCDI JHCFJ EGDEB IJFBG HCHJI JJBDE ICJIE FECJE ECDEF DEIBB AIFEI HECAH
CDHFH: BHFCG
EAGAG: BJDIA
DFBFF: JDBDG
FAEIF: IGDIF
FECJE: ECDEF
JJBDE: ICJIE
HBCDI: JHCFJ
EEBJI: CDHFH
FIEDA: ABDFE
JIGDB: HBIEH
DFFHC: DFBFF,GEFBG
JDBDG: ABDIA,ABDIA,ABDIA
JDBDG ABDIA JDBDG ABDIA JDBDG ABDIA JDBDG ABDIA JDBDG ABDIA JDBDG ABDIA JDBDG ABDIA JDBDG ABDIA JDBDG ABDIA JDBDG ABDIA JDBDG ABDIA JDBDG ABDIA JDBDG ABDIA JDBDG ABDIA JDBDG ABDIA JDBDG ABDIA JDBDG ABDIA JDBDG ABDIA JDBDG ABDIA JDBDG ABDIA JDBDG ABDIA JDBDG ABDIA JDBDG ABDIA JDBDG ABDIA JDBDG ABDIA 
AAAAA FFCFJ EFGCF GCDCF JBCEC BCDFB JJIFI ACIHE CCEHG EDEAA AFIFF BDIAB AFJDJ JAAGA JEIDE GHJIE FDJIJ GCFBC CIECI GGABE EJEDB EDIFF GJEJA CJFBA HIAHH GJEEB JEIDE GHJIE HGGBD DDFCJ FFCIE IHCAA JEJGA ADFFG JECAI IJEFE BEHGF JEIDE GHJIE HEGGG EAFCF EHBHH GEIEB BDDFI IIGAC DDCJI IJEIE BEHCG FJEBJ HFAIA EJEFB
IJEFE: BEHGF
JECAI: IJEFE
CCEHG: EDEAA
HGGBD: DDFCJ
IJEIE: BEHCG
FDJIJ: GCFBC
CJFBA: HIAHH
EDEAA: AFIFF
BDIAB: AFJDJ
JJIFI: ACIHE
BCDFB: JJIFI
GCDCF: JBCEC
GEIEB: BDDFI
GJEEB: JEIDE
IIGAC: DDCJI
AFIFF: BDIAB
EJEFB: 
GGABE: EJEDB
CIECI: GGABE
FFCIE: IHCAA
GCFBC: CIECI
GJEJA: CJFBA
ADFFG: JECAI
AFJDJ: JAAGA
DDCJI: IJEIE
GHJIE: FDJIJ,HGGBD,HEGGG
EJEDB: EDIFF
IHCAA: JEJGA
HEGGG: EAFCF
BDDFI: IIGAC
HFAIA: EJEFB
DDFCJ: FFCIE
JEIDE: GHJIE,GHJIE,GHJIE
JEIDE GHJIE JEIDE GHJIE JEIDE GHJIE JEIDE GHJIE JEIDE GHJIE JEIDE GHJIE JEIDE GHJIE JEIDE GHJIE JEIDE GHJIE JEIDE GHJIE JEIDE GHJIE JEIDE GHJIE JEIDE GHJIE JEIDE GHJIE JEIDE GHJIE JEIDE GHJIE JEIDE GHJIE JEIDE GHJIE JEIDE GHJIE JEIDE GHJIE JEIDE GHJIE JEIDE GHJIE JEIDE GHJIE JEIDE GHJIE JEIDE GHJIE 
AAAAA DADDH EEDHH FJJDC EBIIA GEHIE FCGFF EBAFJ GBJEG DAFAB BCBGJ BFFFF FCDEB IHHBB AECCG JADGJ IHCDF AEEDG BIIIG GDJDE AICEC HCFGD DAEGD AEGIA CDEFC ADCHC GAJCG DAFAB FCDEB IHHBB JDEEJ AECCG JADGJ HEJIH HFHCI EBJCD FEGAH FEDCH ECACF ECIGD JAFAJ GACEJ GCIFH FCDEB AECCG JADGJ CHIFD IDDFF FHBBD BCHFB DIFFB
DAFAB: BCBGJ,FCDEB
IHCDF: AEEDG
FJJDC: EBIIA
DADDH: EEDHH
FCGFF: EBAFJ
FHBBD: BCHFB
EEDHH: FJJDC
ECIGD: JAFAJ
AEGIA: CDEFC
BCHFB: DIFFB
HCFGD: DAEGD
CHIFD: IDDFF
EBAFJ: GBJEG
EBIIA: GEHIE
DIFFB: 
BCBGJ: BFFFF
FCDEB: IHHBB,IHHBB,AECCG
FEGAH: FEDCH
BFFFF: FCDEB
GCIFH: FCDEB
AICEC: HCFGD
JAFAJ: GACEJ
AECCG: JADGJ,JADGJ,JADGJ
AECCG JADGJ AECCG JADGJ AECCG JADGJ AECCG JADGJ AECCG JADGJ AECCG JADGJ AECCG JADGJ AECCG JADGJ AECCG JADGJ AECCG JADGJ AECCG JADGJ AECCG JADGJ AECCG JADGJ AECCG JADGJ AECCG JADGJ AECCG JADGJ AECCG JADGJ AECCG JADGJ AECCG JADGJ AECCG JADGJ AECCG JADGJ AECCG JADGJ AECCG JADGJ AECCG JADGJ AECCG JADGJ 
AAAAA AGBFE GEGJB IJHIE GDEGC GFCDI IJJJD EJEJI GFCIE EJJDD FFAFJ GCGGC FCDCE BDJCA GDEJA EDEFB FBEGJ JEBHB FBHCF IDHGC AAHJC GDBCI CJAAB FCDIG CDECE GFCIE EJJDD FFAFJ BCJHA HFJDB DIDJE DEDAG HBBBB AGJCA CEIFG BJICI GFCDI JGIJA DJAFC GFCIE EJJDD FFAFJ BFBJI BGFDJ HACAG FDFAE AGDJI JGJJC GIGJC GBFAE CDECE
HBBBB: AGJCA
GBFAE: CDECE
BJICI: GFCDI
IDHGC: AAHJC
GDEJA: EDEFB
AAHJC: GDBCI
AGDJI: JGJJC
BGFDJ: HACAG
EDEFB: FBEGJ
FBEGJ: JEBHB
JGJJC: GIGJC
BDJCA: GDEJA
HACAG: FDFAE
GDBCI: CJAAB
CJAAB: FCDIG
EJJDD: FFAFJ,FFAFJ,FFAFJ
EJJDD FFAFJ EJJDD FFAFJ EJJDD FFAFJ EJJDD FFAFJ EJJDD FFAFJ EJJDD FFAFJ EJJDD FFAFJ EJJDD FFAFJ EJJDD FFAFJ EJJDD FFAFJ EJJDD FFAFJ EJJDD FFAFJ EJJDD FFAFJ EJJDD FFAFJ EJJDD FFAFJ EJJDD FFAFJ EJJDD FFAFJ EJJDD FFAFJ EJJDD FFAFJ EJJDD FFAFJ EJJDD FFAFJ EJJDD FFAFJ EJJDD FFAFJ EJJDD FFAFJ EJJDD FFAFJ 
AAAAA BJJDG JBCFC BECBB EJHDA EEADH CCHAE IEIIC CEFIG CDJED HEIBB BEJDA DJBJB CEDJD FCDDG CFAGF HJIFG JGEEG FJHCF FJAHD EHDFB HCAFJ FFIHF BEJDA FEJHH DBFIG ECJFH CEDJD FCDDG BIFEH HFJHG EAGHF EHEGH GDIJJ IEFJG EGCDE DBECE GJJII ECJFH CEDJD FCDDG IGAFG ACGGH GECJI HDACJ HJFBG DFHIJ FIIFD EIEAJ ABFAA JGHCA
EIEAJ: ABFAA
BEJDA: DJBJB,FEJHH
DBFIG: ECJFH
HEIBB: BEJDA
EHEGH: GDIJJ
ABFAA: JGHCA
EAGHF: EHEGH
DFHIJ: FIIFD
IEIIC: CEFIG
CEFIG: CDJED
CFAGF: HJIFG
FFIHF: BEJDA
JGHCA: 
JBCFC: BECBB
ECJFH: CEDJD,CEDJD
ECJFH ECJFH ECJFH ECJFH ECJFH ECJFH ECJFH CEDJD ECJFH CEDJD ECJFH CEDJD ECJFH CEDJD ECJFH ECJFH ECJFH CEDJD ECJFH CEDJD ECJFH CEDJD ECJFH ECJFH CEDJD ECJFH CEDJD ECJFH CEDJD ECJFH CEDJD ECJFH ECJFH ECJFH CEDJD ECJFH CEDJD ECJFH CEDJD ECJFH ECJFH CEDJD ECJFH ECJFH CEDJD ECJFH ECJFH ECJFH CEDJD ECJFH 
AAAAA GAGCD AAEDD EFAJB EIAHF AFEBD HHHAA JGGJD DCAEC AHCIJ IGFJC BGIAJ FEJFG HGDIB JJGIA JFJGF DBJEH JEGCG EEIJE FFBBG CGADI FGIJC GCFGJ FEJFG HGDIB JBHHB ADGIH BJGAG HDJDG AAHHH AHBCC BAIBD DJJCB FBEHG AABBD CFGIG EHGEH BGIAJ GCFGJ FEJFG HGDIB FGHEG HIDCD BDJCG HCDJA DHIFE IFBAG DDGDJ HDGGI HECEG CAAIF
AFEBD: HHHAA
FBEHG: AABBD
JBHHB: ADGIH
BJGAG: HDJDG
DJJCB: FBEHG
FGHEG: HIDCD
HHHAA: JGGJD
GCFGJ: FEJFG,FEJFG
GCFGJ FEJFG GCFGJ FEJFG GCFGJ FEJFG GCFGJ FEJFG GCFGJ FEJFG GCFGJ FEJFG GCFGJ FEJFG GCFGJ FEJFG GCFGJ FEJFG GCFGJ FEJFG GCFGJ FEJFG GCFGJ FEJFG GCFGJ FEJFG GCFGJ FEJFG GCFGJ FEJFG GCFGJ FEJFG GCFGJ FEJFG GCFGJ FEJFG GCFGJ FEJFG GCFGJ FEJFG GCFGJ FEJFG GCFGJ FEJFG GCFGJ FEJFG GCFGJ FEJFG GCFGJ FEJFG 
AAAAA EJBAJ GCBDJ FDAAJ AAEHF CEJAI HAIAE EIJGI EJADA DCDDD CBIEE HHBHI BGCAI AEEJE IHDDE JFEII EGABH IGJAE BDDHE IIJFF EEFJJ HCEJF JBCCD BDIFJ GHGFF IHDDE JFEII EGABH AICEG CJBBB JACIE CBGFH FBEJH JCGHH GCJCG JHFDJ DHEED GHHFB JFGIA BGCAI FBHDJ JFEII EGABH DIAHD FJGDE ICJCE AHICI AICBH BJEDC DEJAD JGDFD
HAIAE: EIJGI
BDDHE: IIJFF
DEJAD: JGDFD
ICJCE: AHICI
EJADA: DCDDD
HCEJF: JBCCD
FDAAJ: AAEHF
BJEDC: DEJAD
JHFDJ: DHEED
EJBAJ: GCBDJ
JCGHH: GCJCG
AEEJE: IHDDE
DCDDD: CBIEE
GHHFB: JFGIA
FBEJH: JCGHH
JFEII: EGABH,EGABH,EGABH
JFEII EGABH JFEII EGABH JFEII EGABH JFEII EGABH JFEII EGABH JFEII EGABH JFEII EGABH JFEII EGABH JFEII EGABH JFEII EGABH JFEII EGABH JFEII EGABH JFEII EGABH JFEII EGABH JFEII EGABH JFEII EGABH JFEII EGABH JFEII EGABH JFEII EGABH JFEII EGABH JFEII EGABH JFEII EGABH JFEII EGABH JFEII EGABH JFEII EGABH 
AAAAA DDCAB FEICH HFBDI AHJCA JDBJH EDGJH JGJJH CJHJH IGBAF AABFC EHDJJ FHJFG EDFDD FIJAB GCDCA ECABF HCJHI CJGFA IICCG FIDFI IGBAF DCFEA AABFC EHDJJ FHJFG BCBEC IACCF FHCBI HAFAF BHDEI EHDJJ FHJFG IEBJD CIICA AHEBE BGGFA HJCJA GGFGA ECAHH EIEFC CAFFA GJCHI HEDJE HCGFB IFEBI CJHJH DCFEA EHDJJ FHJFG GAHGD
IACCF: FHCBI
FEICH: HFBDI
AHJCA: JDBJH
EHDJJ: FHJFG,FHJFG,FHJFG,FHJFG
EHDJJ FHJFG EHDJJ FHJFG EHDJJ FHJFG EHDJJ FHJFG EHDJJ FHJFG EHDJJ FHJFG EHDJJ FHJFG EHDJJ FHJFG EHDJJ FHJFG EHDJJ FHJFG EHDJJ FHJFG EHDJJ FHJFG EHDJJ FHJFG EHDJJ FHJFG EHDJJ FHJFG EHDJJ FHJFG EHDJJ FHJFG EHDJJ FHJFG EHDJJ FHJFG EHDJJ FHJFG EHDJJ FHJFG EHDJJ FHJFG EHDJJ FHJFG EHDJJ FHJFG EHDJJ FHJFG 
AAAAA AGIGH CJIAE IDDEE EAAEC DFEFJ IEIJH FBHCB IAFAJ FAHAE FBEBD FFAJF AAFJC IBDIA IDEAD CIDIF FHAJJ FCFAD FBHCB BHCJE IAFAJ FAHAE DJAEH JDJJE IHFGH CIDBF DDIFJ CCGAB CFGAC GDGEE BHCJE IAFAJ FAHAE DCDGA DFDJC EDEJE GAJCH JJFCF JHAAI ICDAD IDHGI FCFAD FBHCB IAFAJ FAHAE IAECF JCFFB IHEHF IGCDC IAHFD FHAJJ
FBHCB: IAFAJ,BHCJE,IAFAJ
JHAAI: ICDAD
IAECF: JCFFB
DFEFJ: IEIJH
AAFJC: IBDIA
GDGEE: BHCJE
JJFCF: JHAAI
FFAJF: AAFJC
CJIAE: IDDEE
IEIJH: FBHCB
EAAEC: DFEFJ
IDEAD: CIDIF
IGCDC: IAHFD
EDEJE: GAJCH
DCDGA: DFDJC
IDDEE: EAAEC
IHFGH: CIDBF
CFGAC: GDGEE
CCGAB: CFGAC
DJAEH: JDJJE
IAFAJ: FAHAE,FAHAE,FAHAE,FAHAE
FAHAE IAFAJ FAHAE IAFAJ FAHAE IAFAJ FAHAE IAFAJ FAHAE IAFAJ FAHAE IAFAJ FAHAE IAFAJ FAHAE IAFAJ FAHAE IAFAJ FAHAE IAFAJ FAHAE IAFAJ FAHAE IAFAJ FAHAE IAFAJ FAHAE IAFAJ FAHAE IAFAJ FAHAE IAFAJ FAHAE IAFAJ FAHAE IAFAJ FAHAE IAFAJ FAHAE IAFAJ FAHAE IAFAJ FAHAE IAFAJ FAHAE IAFAJ FAHAE IAFAJ FAHAE IAFAJ 
AAAAA EBBFG HIIFF JAFJJ GJJEF FCECC JJECG AFCGG GFGAD DJBED AHFFJ CHHGD BCGED IJGEI BJEAG IHDII ABIEI FCECC JFHJC JHIAG HIIGG HJBAA GFGAD DJBED AHFFJ CAIFD EFIDF JFHFG JAGAC EJGDJ ADEGI DGBJH CAEAF ACHHC HCBJI GFJCD IAAJI AFCGG DJBED AHFFJ EFAIB FADBB IJGJC IFFHH EDGGE CCDFD EBEDC AAEIB CIHHI EGAFI ABBCH
IJGEI: BJEAG
EJGDJ: ADEGI
ADEGI: DGBJH
FADBB: IJGJC
EBBFG: HIIFF
CIHHI: EGAFI
FCECC: JJECG,JFHJC
DGBJH: CAEAF
IJGJC: IFFHH
CAIFD: EFIDF
JAFJJ: GJJEF
GJJEF: FCECC
AHFFJ: CHHGD,CAIFD,EFAIB
CCDFD: EBEDC
AFCGG: GFGAD,DJBED
CAEAF: ACHHC
EBEDC: AAEIB
IAAJI: AFCGG
GFGAD: DJBED,DJBED
GFGAD DJBED GFGAD DJBED GFGAD DJBED GFGAD DJBED GFGAD DJBED GFGAD DJBED GFGAD DJBED GFGAD DJBED GFGAD DJBED GFGAD DJBED GFGAD DJBED GFGAD DJBED GFGAD DJBED GFGAD DJBED GFGAD DJBED GFGAD DJBED GFGAD DJBED GFGAD DJBED GFGAD DJBED GFGAD DJBED GFGAD DJBED GFGAD DJBED GFGAD DJBED GFGAD DJBED GFGAD DJBED 
AAAAA ECJDI CEBGD BAADI IGAJF GEHIJ CGHBI FBADH IIDFI ECCDC BDCHG HJEHA JIJAD AJJGA HHHHB JJAIH HFCEE CFJIB FDGEG EIJDJ HBAJG CCAEA HGBEE DGBBA CGHBI IIDFI ECCDC FJIEG GICAG JCEEI HBHCJ JHFJD FJGDC AAAED GFDGC EAIBD CCDHH BGGHA EGFBA IIDFI ECCDC GCAGE FDHDB JEIDF JIBJB DJDCF HGGII ADDJF IIDFI ECCDC EHHCG
IGAJF: GEHIJ
HBHCJ: JHFJD
DGBBA: CGHBI
JJAIH: HFCEE
FDGEG: EIJDJ
DJDCF: HGGII
FBADH: IIDFI
FDHDB: JEIDF
JHFJD: FJGDC
ECCDC: BDCHG,FJIEG,GCAGE,EHHCG
AJJGA: HHHHB
GCAGE: FDHDB
HHHHB: JJAIH
JCEEI: HBHCJ
JIJAD: AJJGA
GICAG: JCEEI
HGGII: ADDJF
HBAJG: CCAEA
GFDGC: EAIBD
HGBEE: DGBBA
FJIEG: GICAG
ADDJF: IIDFI
FJGDC: AAAED
BAADI: IGAJF
CGHBI: FBADH,IIDFI
EHHCG: 
BDCHG: HJEHA
IIDFI: ECCDC,ECCDC,ECCDC,ECCDC
IIDFI ECCDC IIDFI ECCDC IIDFI ECCDC IIDFI ECCDC IIDFI ECCDC IIDFI ECCDC IIDFI ECCDC IIDFI ECCDC IIDFI ECCDC IIDFI ECCDC IIDFI ECCDC IIDFI ECCDC IIDFI ECCDC IIDFI ECCDC IIDFI ECCDC IIDFI ECCDC IIDFI ECCDC IIDFI ECCDC IIDFI ECCDC IIDFI ECCDC IIDFI ECCDC IIDFI ECCDC IIDFI ECCDC IIDFI ECCDC IIDFI ECCDC 
AAAAA GIEGG IGCAC BHJDF CHAAC FCJDF JFIAI BEDBC BJEJE BHADF DDGFD GJBJG EGIAA FFIFH DBFFE CCFDH AIFEE GDBJI JHJFA HIJGE JGJCC EHBAB FBEGF EGIAA FFIFH EDHGA EIDJB GABFE IABJI EDBIE IFDHG CIHFA EGIAA FFIFH DHDEH CCJCB DIFFB JEBCI EHGAI EBAGJ GFFAD GHIFB FDFII DGBHG FGJGA EGIAA FFIFH CGIDG GHHGF HHIGF DJBDE
HHIGF: DJBDE
DGBHG: FGJGA
GIEGG: IGCAC
FGJGA: EGIAA
GHIFB: FDFII
CIHFA: EGIAA
BEDBC: BJEJE
DDGFD: GJBJG
GABFE: IABJI
DJBDE: 
DIFFB: JEBCI
EHGAI: EBAGJ
CHAAC: FCJDF
FDFII: DGBHG
GJBJG: EGIAA
JHJFA: HIJGE
EIDJB: GABFE
EHBAB: FBEGF
EBAGJ: GFFAD
HIJGE: JGJCC
EDBIE: IFDHG
CCFDH: AIFEE
JFIAI: BEDBC
GFFAD: GHIFB
EGIAA: FFIFH,FFIFH,FFIFH,FFIFH
EGIAA FFIFH EGIAA FFIFH EGIAA FFIFH EGIAA FFIFH EGIAA FFIFH EGIAA FFIFH EGIAA FFIFH EGIAA FFIFH EGIAA FFIFH EGIAA FFIFH EGIAA FFIFH EGIAA FFIFH EGIAA FFIFH EGIAA FFIFH EGIAA FFIFH EGIAA FFIFH EGIAA FFIFH EGIAA FFIFH EGIAA FFIFH EGIAA FFIFH EGIAA FFIFH EGIAA FFIFH EGIAA FFIFH EGIAA FFIFH EGIAA FFIFH 
AAAAA CIJFH GIDID BDIBE BDFIH DAAGE JHHGE HHGJC GIGEE GIAFH CEADE CGJFA IADCE EIJHJ CEGEB HBFEF IBBCG BCBCA EHDCC DGBHB BDEGF JHHGE AHDFH GGFIE BJDGA GIAFH CEADE HAIHH HHCEA EBCHB IACAD IEBCE HIJHF DCHGD JCCDE DCECJ GGFIE GIAFH CEADE CAADC EEJBB FAIAH EEFEI JDAHG EAIJI AIEEH GIGEE GIAFH CEADE CCBFH BFIJH
CEGEB: HBFEF
EAIJI: AIEEH
HBFEF: IBBCG
BDFIH: DAAGE
BFIJH: 
EEJBB: FAIAH
BDEGF: JHHGE
EHDCC: DGBHB
CGJFA: IADCE
DCECJ: GGFIE
CCBFH: BFIJH
AIEEH: GIGEE
JCCDE: DCECJ
JHHGE: HHGJC,AHDFH
HAIHH: HHCEA
IBBCG: BCBCA
GIAFH: CEADE,CEADE,CEADE,CEADE
GIAFH CEADE GIAFH CEADE GIAFH CEADE GIAFH CEADE GIAFH CEADE GIAFH CEADE GIAFH CEADE GIAFH CEADE GIAFH CEADE GIAFH CEADE GIAFH CEADE GIAFH CEADE GIAFH CEADE GIAFH CEADE GIAFH CEADE GIAFH CEADE GIAFH CEADE GIAFH CEADE GIAFH CEADE GIAFH CEADE GIAFH CEADE GIAFH CEADE GIAFH CEADE GIAFH CEADE GIAFH CEADE 
AAAAA EJBFC GHBGH FCDIG GFGDB ECEFB CAFDJ FEBAD GAAGC AHEHJ HIFJA BEEJF FFIED EFHJA CJAEG IDFBD HGHFD BABAD ADIIG IFBEF EAAFB GAAGC AHEHJ IAIGE IGEIF EECAE FAJGG IDEGD DAFCB IFBEF HAGFF GAAGC AHEHJ FFCHA EBIEF BJJBE CAGBC DFCGJ CCECB HHDAB HAGCG AJBHA GAAGC AHEHJ EGAGF CFEEH HHAAI FAEAA CCFAD GCDHD JDBAJ
HIFJA: BEEJF
EAAFB: GAAGC
CJAEG: IDFBD
GAAGC: AHEHJ,AHEHJ,AHEHJ,AHEHJ
GAAGC AHEHJ GAAGC AHEHJ GAAGC AHEHJ GAAGC AHEHJ GAAGC AHEHJ GAAGC AHEHJ GAAGC AHEHJ GAAGC AHEHJ GAAGC AHEHJ GAAGC AHEHJ GAAGC AHEHJ GAAGC AHEHJ GAAGC AHEHJ GAAGC AHEHJ GAAGC AHEHJ GAAGC AHEHJ GAAGC AHEHJ GAAGC AHEHJ GAAGC AHEHJ GAAGC AHEHJ GAAGC AHEHJ GAAGC AHEHJ GAAGC AHEHJ GAAGC AHEHJ GAAGC AHEHJ 
AAAAA AJCBJ JIFJA ABGIF FIGIE GBAID FJBFI AEFGI IEIHJ IBAHA HBDJJ ICJFI BHDGH ABCIF EEFJE DBDFG IADEA GIJJB ECDEH HCIFJ HIABJ JIJCB FJJDG FJBFI JFIAB AEFGI IEIHJ EIHHB FJDJI HFCDJ HCGIH HBEBE BJCHG GABGA FJBFI JFIAB AEFGI IEIHJ GDAAI JHHCA EGIDH BEFFG DCDHA CDFDB JBFFE GCHEE JFICH GBGBF IAAGH FJBFI AEFGI
FIGIE: GBAID
EEFJE: DBDFG
ABCIF: EEFJE
ABGIF: FIGIE
AEFGI: IEIHJ,IEIHJ,IEIHJ
IEIHJ AEFGI IEIHJ AEFGI IEIHJ AEFGI IEIHJ AEFGI IEIHJ AEFGI IEIHJ AEFGI IEIHJ AEFGI IEIHJ AEFGI IEIHJ AEFGI IEIHJ AEFGI IEIHJ AEFGI IEIHJ AEFGI IEIHJ AEFGI IEIHJ AEFGI IEIHJ AEFGI IEIHJ AEFGI IEIHJ AEFGI IEIHJ AEFGI IEIHJ AEFGI IEIHJ AEFGI IEIHJ AEFGI IEIHJ AEFGI IEIHJ AEFGI IEIHJ AEFGI IEIHJ AEFGI 
AAAAA BEJBI BHIJD IJGGD GGBGB ICGIH FDIGI JJAHE BHEAG HAJGJ DBIAI AFGEA FBDIJ HADDA BHAAD DGDHD DDCJC FBFGA IDJCC GHDDI BHEAG DBIAI AFGEA DHFGE CEBBF HDDDJ EEADA HGEIJ FFIHF DEIFH FGDJA BFHFE HAJGJ DBIAI AFGEA ACJEI BADIG FAFHE IICIE IJABJ JIEBF HGAGI JHGGJ HAJGJ DBIAI AFGEA DHGBD AIEAA JCCBH CHDDF JAJGF
DBIAI: AFGEA,AFGEA,AFGEA,AFGEA
DBIAI AFGEA DBIAI AFGEA DBIAI AFGEA DBIAI AFGEA DBIAI AFGEA DBIAI AFGEA DBIAI AFGEA DBIAI AFGEA DBIAI AFGEA DBIAI AFGEA DBIAI AFGEA DBIAI AFGEA DBIAI AFGEA DBIAI AFGEA DBIAI AFGEA DBIAI AFGEA DBIAI AFGEA DBIAI AFGEA DBIAI AFGEA DBIAI AFGEA DBIAI AFGEA DBIAI AFGEA DBIAI AFGEA DBIAI AFGEA DBIAI AFGEA 
AAAAA BEEIJ AIEAD GJFJF IBGGA CCGBA EIHFA HIBAG HGJHE HBBIC CIAIA EIHII BHCHG JBAHH HCJHD JIDEA JGJDH DBEBB BHFHF DAHCD JHEDA CIAIA EIHII BHCHG JAHJJ BCBAH AABBG IEGCC GHJHH JJFHG GCBBG IDCGA CIAIA EIHII BHCHG HJAJG EAGED GICGJ GFJED GGFIC DEEHG FAIDD IHAFB BBJCE CIAIA EIHII BHCHG EAJBF IBGJA DEIDJ DCDED
GGFIC: DEEHG
AABBG: IEGCC
JGJDH: DBEBB
DEIDJ: DCDED
BBJCE: CIAIA
HBBIC: CIAIA
GICGJ: GFJED
FAIDD: IHAFB
EAJBF: IBGJA
AIEAD: GJFJF
EIHFA: HIBAG
IHAFB: BBJCE
DBEBB: BHFHF
BCBAH: AABBG
DAHCD: JHEDA
JHEDA: CIAIA
IBGGA: CCGBA
CCGBA: EIHFA
JIDEA: JGJDH
EAGED: GICGJ
DEEHG: FAIDD
JAHJJ: BCBAH
GFJED: GGFIC
HGJHE: HBBIC
GJFJF: IBGGA
GCBBG: IDCGA
GHJHH: JJFHG
HIBAG: HGJHE
EIHII: BHCHG,BHCHG,BHCHG,BHCHG
EIHII BHCHG EIHII BHCHG EIHII BHCHG EIHII BHCHG EIHII BHCHG EIHII BHCHG EIHII BHCHG EIHII BHCHG EIHII BHCHG EIHII BHCHG EIHII BHCHG EIHII BHCHG EIHII BHCHG EIHII BHCHG EIHII BHCHG EIHII BHCHG EIHII BHCHG EIHII BHCHG EIHII BHCHG EIHII BHCHG EIHII BHCHG EIHII BHCHG EIHII BHCHG EIHII BHCHG EIHII BHCHG 
AAAAA GADCA CFAAI GGBBD IBCFE ABEGI BDBJH FGGAE IBBFJ GCAFE CFJJE JJIGE HEBJA BCBBH BAHAE HEDFE AAFFB HBGFE JBADC FHBDJ BDBJH GCAFE CCCDI IDHDC CFJJE JJIGE CHJHD IJJAD JDAJD CGAFE BIBHH JDECD EIAIE AIGIC ICHGF IDHDC CFJJE JJIGE HCDEE JABJA FHBDC EDEGA DFDBD BCGBC JGBCF ABJII EIBBI GCAFE CFJJE JJIGE HICDE
GADCA: CFAAI
CFJJE: JJIGE,JJIGE,JJIGE,JJIGE
CFJJE JJIGE CFJJE JJIGE CFJJE JJIGE CFJJE JJIGE CFJJE JJIGE CFJJE JJIGE CFJJE JJIGE CFJJE JJIGE CFJJE JJIGE CFJJE JJIGE CFJJE JJIGE CFJJE JJIGE CFJJE JJIGE CFJJE JJIGE CFJJE JJIGE CFJJE JJIGE CFJJE JJIGE CFJJE JJIGE CFJJE JJIGE CFJJE JJIGE CFJJE JJIGE CFJJE JJIGE CFJJE JJIGE CFJJE JJIGE CFJJE JJIGE 
AAAAA HFIFH EDGCH DGHGF IHGHB GAAAI IFHFD AECJJ IDCAB EDAED HJJGH CAAAG HHCGJ BFFCG GCEGA DEBIE GCJJC IIFFA IDCAB EDAED BBABF DCJAF GGCIB AJABE CEEGB HBCEF DJBCJ IDBCA EAHFG IFJAH IIFFA IDCAB EDAED BEGIH ICGII AHIFD GAAAI FDHCH JIGBD FCHHI AECJJ IIFFA IDCAB EDAED EBFCJ FIEGC BIDDC JGAFE DAHFF FJJFD HIFHF
DAHFF: FJJFD
EBFCJ: FIEGC
AJABE: CEEGB
HFIFH: EDGCH
DJBCJ: IDBCA
GAAAI: IFHFD,FDHCH
IFHFD: AECJJ
BBABF: DCJAF
AHIFD: GAAAI
HHCGJ: BFFCG
GGCIB: AJABE
HIFHF: 
DCJAF: GGCIB
IDBCA: EAHFG
HJJGH: CAAAG
BIDDC: JGAFE
CAAAG: HHCGJ
DEBIE: GCJJC
EDGCH: DGHGF
EDAED: HJJGH,BBABF,BEGIH,EBFCJ
BEGIH: ICGII
IDCAB: EDAED,EDAED,EDAED,EDAED
IDCAB EDAED IDCAB EDAED IDCAB EDAED IDCAB EDAED IDCAB EDAED IDCAB EDAED IDCAB EDAED IDCAB EDAED IDCAB EDAED IDCAB EDAED IDCAB EDAED IDCAB EDAED IDCAB EDAED IDCAB EDAED IDCAB EDAED IDCAB EDAED IDCAB EDAED IDCAB EDAED IDCAB EDAED IDCAB EDAED IDCAB EDAED IDCAB EDAED IDCAB EDAED IDCAB EDAED IDCAB EDAED 
AAAAA BCDBC GDGFE GDHHA CDHAF JGJJG FJHJC EDACH CJHGH HJFAI GIAHC IACEI CIGFB DGFGA FGHCB HEBEC JCFCH IIGCE ADJIJ ADJED AIFBA BFCEG GGIHD CIGFB DGFGA EGFHC ACEAE JJIDC FCJFG EBACE HEHDB DEEII EBIBF CJJJC CIGFB DGFGA CCJJE IIABC BIAJC AEJDI JJAJJ GIEIH ICAHC BCIDG EGIHC GGIHD CIGFB DGFGA BFFFC GHJFA HCCAJ
FGHCB: HEBEC
DEEII: EBIBF
GIEIH: ICAHC
IACEI: CIGFB
HJFAI: GIAHC
GIAHC: IACEI
BFFFC: GHJFA
CCJJE: IIABC
GDHHA: CDHAF
HCCAJ: 
JJAJJ: GIEIH
EGIHC: GGIHD
CJHGH: HJFAI
CIGFB: DGFGA,DGFGA,DGFGA,DGFGA
CIGFB DGFGA CIGFB DGFGA CIGFB DGFGA CIGFB DGFGA CIGFB DGFGA CIGFB DGFGA CIGFB DGFGA CIGFB DGFGA CIGFB DGFGA CIGFB DGFGA CIGFB DGFGA CIGFB DGFGA CIGFB DGFGA CIGFB DGFGA CIGFB DGFGA CIGFB DGFGA CIGFB DGFGA CIGFB DGFGA CIGFB DGFGA CIGFB DGFGA CIGFB DGFGA CIGFB DGFGA CIGFB DGFGA CIGFB DGFGA CIGFB DGFGA 
AAAAA GJCAE JJDCA CFDHD AHCEB JCGJA FBJCA DCGGF FJFGA AHBHC EJFFD IDIJH JIDBB ACGGB HHBHC GBHJJ GHGHI CEJFE GJCAJ FBJCA JACAF EJFFD GJCJE IDIJH JIDBB GIICD GGDIJ HHCJI BACCG IGBGH CIDID DEACE HHJBG HGGCH AHBHC HBHBE GJCJE IDIJH JIDBB BICAI BCBFE FAFJH HJECA IDHEC DEJGA BAJIG EFCIA HGFGG BFIJH IIGGE AHBHC
IDIJH: JIDBB,JIDBB,JIDBB
IDIJH JIDBB IDIJH JIDBB IDIJH JIDBB IDIJH JIDBB IDIJH JIDBB IDIJH JIDBB IDIJH JIDBB IDIJH JIDBB IDIJH JIDBB IDIJH JIDBB IDIJH JIDBB IDIJH JIDBB IDIJH JIDBB IDIJH JIDBB IDIJH JIDBB IDIJH JIDBB IDIJH JIDBB IDIJH JIDBB IDIJH JIDBB IDIJH JIDBB IDIJH JIDBB IDIJH JIDBB IDIJH JIDBB IDIJH JIDBB IDIJH JIDBB 
AAAAA FCJGF AACFE GCICD BBCHE JHFCF BHJAI DBCEG GFHAC CBJAJ HFFBJ AADFG FHBAI AICFA JDAHJ DDBBD JFGBB HJIBD FGGAI JEFDE DBHHD DBCEG JGCBF IABBH FHBAI AICFA CIGDC DAAIG EIIFG DFHBA FJCIE AJDJE HFHFA ADHIH DCFAG AADFG FHBAI AICFA IHBCI HHJJF AACHJ CDDAD EDIFE AGGCE EBJBD DCJBB DBHHD IEIBA FJCIE JGCBF HFFBJ
AACHJ: CDDAD
HFFBJ: AADFG
JEFDE: DBHHD
AADFG: FHBAI,FHBAI
FHBAI AADFG FHBAI AADFG FHBAI AADFG FHBAI AADFG FHBAI AADFG FHBAI AADFG FHBAI AADFG FHBAI AADFG FHBAI AADFG FHBAI AADFG FHBAI AADFG FHBAI AADFG FHBAI AADFG FHBAI AADFG FHBAI AADFG FHBAI AADFG FHBAI AADFG FHBAI AADFG FHBAI AADFG FHBAI AADFG FHBAI AADFG FHBAI AADFG FHBAI AADFG FHBAI AADFG FHBAI AADFG 
AAAAA JAEIA HIBFF AJHBF GAGAF EBEAF BBCEC DJEEA IDCCI EDFIF BEEGI GFAAA DBGAE CAEIH BAGHG BCGHB JHGHJ IIACH CBFBC JHCCD IDACI AEFBB EDGDC BJGCB JEJAA BECJJ CAEIH BAGHG BCGHB FIBDE GDJGA DECGB DDHED IFBFH GEGID DBGAE CAEIH BAGHG BCGHB JCIHH GDDHI EIDFI FEHIA CGAEH IIIFD AHBIB IEHCJ AEJAI HGGGC EDFIF BAJEA
CAEIH: BAGHG,BAGHG,BAGHG
CAEIH BAGHG CAEIH BAGHG CAEIH BAGHG CAEIH BAGHG CAEIH BAGHG CAEIH BAGHG CAEIH BAGHG CAEIH BAGHG CAEIH BAGHG CAEIH BAGHG CAEIH BAGHG CAEIH BAGHG CAEIH BAGHG CAEIH BAGHG CAEIH BAGHG CAEIH BAGHG CAEIH BAGHG CAEIH BAGHG CAEIH BAGHG CAEIH BAGHG CAEIH BAGHG CAEIH BAGHG CAEIH BAGHG CAEIH BAGHG CAEIH BAGHG 
AAAAA JEICF IGICH HCFAF AFEAD EBAFH JAHHI HJEFC EDEEA IIIDD JCJCE EAJBF EFHJI DFDFB GEDEF AJIHJ ABCEA AJHBJ BIFFH BHDDJ CFJFD AEJJE EDEEA HCGBB DCJEI JCJCE EFHJI DFDFB JAJHG FDGBD FBGCD AEBIF HDBHG EAJJC EAJBF EFHJI DFDFB EGHJG BIHFG CAEJA BJFJD JAJCG BDCGH HGJDA AEJJE CFIGF ICDHH FEBFI JABHH EAJBF EFHJI
JEICF: IGICH
IGICH: HCFAF
JAJHG: FDGBD
HGJDA: AEJJE
FDGBD: FBGCD
ICDHH: FEBFI
EAJBF: EFHJI,EFHJI,EFHJI
EAJBF EFHJI EAJBF EFHJI EAJBF EFHJI EAJBF EFHJI EAJBF EFHJI EAJBF EFHJI EAJBF EFHJI EAJBF EFHJI EAJBF EFHJI EAJBF EFHJI EAJBF EFHJI EAJBF EFHJI EAJBF EFHJI EAJBF EFHJI EAJBF EFHJI EAJBF EFHJI EAJBF EFHJI EAJBF EFHJI EAJBF EFHJI EAJBF EFHJI EAJBF EFHJI EAJBF EFHJI EAJBF EFHJI EAJBF EFHJI EAJBF EFHJI 
AAAAA FGCIE GCHFH GJIJF IBEDI CFCBH FDAIC AAEHA HBCGC EHACG AHHAD BJBDG GDCHF CDJBH GHBGC CAEHG ADIGG JBBAA IGCFI BBGDJ EFIFI HBCGC EHACG EBGAA IBACE FIFDD IEIGI EDEAG BIEDI DFGCC ICFJB JGFFJ DJFHG CGJDI EADAE FBIGH HBCGC EHACG IDCJA ICJAH HGDHD JEAJF ECHAG GHHGD EGIAB JIJDF JIFHC AAJHD CBEHE BBGJG GBFFG
CFCBH: FDAIC
EHACG: AHHAD,EBGAA,IDCJA
FGCIE: GCHFH
CDJBH: GHBGC
ECHAG: GHHGD
GHBGC: CAEHG
GDCHF: CDJBH
CAEHG: ADIGG
GCHFH: GJIJF
EFIFI: HBCGC
DFGCC: ICFJB
AHHAD: BJBDG
IBEDI: CFCBH
EADAE: FBIGH
BBGJG: GBFFG
JIFHC: AAJHD
EGIAB: JIJDF
BJBDG: GDCHF
GJIJF: IBEDI
FIFDD: IEIGI
AAEHA: HBCGC
GHHGD: EGIAB
IBACE: FIFDD
BIEDI: DFGCC
ADIGG: JBBAA
IDCJA: ICJAH
FDAIC: AAEHA
JEAJF: ECHAG
HBCGC: EHACG,EHACG,EHACG
EHACG HBCGC EHACG HBCGC EHACG HBCGC EHACG HBCGC EHACG HBCGC EHACG HBCGC EHACG HBCGC EHACG HBCGC EHACG HBCGC EHACG HBCGC EHACG HBCGC EHACG HBCGC EHACG HBCGC EHACG HBCGC EHACG HBCGC EHACG HBCGC EHACG HBCGC EHACG HBCGC EHACG HBCGC EHACG HBCGC EHACG HBCGC EHACG HBCGC EHACG HBCGC EHACG HBCGC EHACG HBCGC 
AAAAA IIGBD GCEHE DFFJG JAJFF GJIFA AIIHH IHDEC BCJDG FFFAC CIGHJ IHJDC HAEGI CFGAE DJGFI IAAEJ GGFIF HJIAB DAEED AEFCI AECBI DFGFI EFHHE GABJC BBHIE FBCAD HADCI IHJDC HAEGI HFGII CIDIG FDIBJ CEIII HGJHJ JHEDA DHEIA IECCD HADCI IHJDC HAEGI DIDBG CBJHG BHDCE ABBJF EBIBG HHDDF ICJDJ HGCCB CJCED CIGHJ CCGJE
GABJC: BBHIE
HJIAB: DAEED
CEIII: HGJHJ
HGCCB: CJCED
HADCI: IHJDC,IHJDC
IHJDC HADCI IHJDC HADCI IHJDC HADCI IHJDC HADCI IHJDC HADCI IHJDC HADCI IHJDC HADCI IHJDC HADCI IHJDC HADCI IHJDC HADCI IHJDC HADCI IHJDC HADCI IHJDC HADCI IHJDC HADCI IHJDC HADCI IHJDC HADCI IHJDC HADCI IHJDC HADCI IHJDC HADCI IHJDC HADCI IHJDC HADCI IHJDC HADCI IHJDC HADCI IHJDC HADCI IHJDC HADCI 
AAAAA IFJFE AHIDI CIECC HAGHG HAGFA EBHHF AEIDC BCIFF HEIIB DCHHC DJCEJ FDBCH FGCJA HCGEI BEIGJ DDAEF AIJEE FBFAF GICGH AHCCE JEACC BJDGH BHGGJ DJCEJ FDBCH IFCCB CEECJ BAAJH AJJGJ IJIGD BGJJG GFIFF EEHCD BHGGJ DJCEJ FDBCH GBDII FAGGF AIGIF FIFAC EAHFC GDBGH FCBJB FIJIC EBAJF DJCEJ FDBCH DFADJ CDADA IHFCD
IFJFE: AHIDI
CEECJ: BAAJH
FIJIC: EBAJF
GDBGH: FCBJB
DFADJ: CDADA
AHIDI: CIECC
GBDII: FAGGF
HCGEI: BEIGJ
AHCCE: JEACC
CIECC: HAGHG
HEIIB: DCHHC
EEHCD: BHGGJ
FBFAF: GICGH
AEIDC: BCIFF
DCHHC: DJCEJ
AIGIF: FIFAC
FDBCH: FGCJA,IFCCB,GBDII,DFADJ
BHGGJ: DJCEJ,DJCEJ
BHGGJ DJCEJ BHGGJ DJCEJ BHGGJ DJCEJ BHGGJ DJCEJ BHGGJ DJCEJ BHGGJ DJCEJ BHGGJ DJCEJ BHGGJ DJCEJ BHGGJ DJCEJ BHGGJ DJCEJ BHGGJ DJCEJ BHGGJ DJCEJ BHGGJ DJCEJ BHGGJ DJCEJ BHGGJ DJCEJ BHGGJ DJCEJ BHGGJ DJCEJ BHGGJ DJCEJ BHGGJ DJCEJ BHGGJ DJCEJ BHGGJ DJCEJ BHGGJ DJCEJ BHGGJ DJCEJ BHGGJ DJCEJ BHGGJ DJCEJ 
AAAAA GCGEH EBHDD DDBDB EBIHH AJEBH IADBD CJDGH GABBB FHCGE FEBJG FCIBG HHAGC IDEIB GIEBA DABGB DIFJH CIIIC CCHGF IBHFJ JDGJD JFEAI CJFJE ICGBI FCIBG HHAGC HEFEI DGBFJ BBEDD HGDFA CGDJD IBFDF CGCJG FEBJG FCIBG HHAGC GEAGI GCFDD EBBAD IGECD CIHCC EJHJB JFCAJ IDJEB FCIBG HHAGC JEACH JCHGI JFGBI IEACH JAGIG
EBBAD: IGECD
GABBB: FHCGE
FHCGE: FEBJG
JEACH: JCHGI
EBIHH: AJEBH
CJDGH: GABBB
HEFEI: DGBFJ
FEBJG: FCIBG,FCIBG
FEBJG FCIBG FEBJG FCIBG FEBJG FCIBG FEBJG FCIBG FEBJG FCIBG FEBJG FCIBG FEBJG FCIBG FEBJG FCIBG FEBJG FCIBG FEBJG FCIBG FEBJG FCIBG FEBJG FCIBG FEBJG FCIBG FEBJG FCIBG FEBJG FCIBG FEBJG FCIBG FEBJG FCIBG FEBJG FCIBG FEBJG FCIBG FEBJG FCIBG FEBJG FCIBG FEBJG FCIBG FEBJG FCIBG FEBJG FCIBG FEBJG FCIBG 
AAAAA EEDBC AHCCH JGCIE ICAHF GHADF EEJJA GHDBC HABBI ADHJE DICDD ACCEC CFDBF HHJAF HBBAJ JABFD FHGHE ABBJG JFGJF BDBDF JEEBE AIBHH ACCEC GJAEA CFDBF HHJAF IAEGI FCCDE EIAEJ CFBFD CDHCI BJEID CJIJA ADBIH FAHAJ GFCBH JEAGA FCFFI CEDCC JCCFC FAIDB DICDD ACCEC CFDBF HHJAF EBGDH ICCFD JCCBA AHEIE IAHIC GCBDH
ICCFD: JCCBA
JFGJF: BDBDF
JEEBE: AIBHH
FHGHE: ABBJG
FCFFI: CEDCC
GFCBH: JEAGA
CDHCI: BJEID
HBBAJ: JABFD
BJEID: CJIJA
CJIJA: ADBIH
EIAEJ: CFBFD
HABBI: ADHJE
EEJJA: GHDBC
ADHJE: DICDD
ACCEC: CFDBF,GJAEA,CFDBF
GHDBC: HABBI
AHCCH: JGCIE
EEDBC: AHCCH
IAEGI: FCCDE
FAIDB: DICDD
ICAHF: GHADF
ADBIH: FAHAJ
JABFD: FHGHE
JGCIE: ICAHF
AIBHH: ACCEC
CFBFD: CDHCI
FCCDE: EIAEJ
EBGDH: ICCFD
GCBDH: 
GHADF: EEJJA
DICDD: ACCEC,ACCEC
DICDD ACCEC DICDD DICDD DICDD DICDD DICDD DICDD DICDD DICDD DICDD ACCEC DICDD DICDD DICDD DICDD DICDD DICDD ACCEC DICDD DICDD ACCEC DICDD DICDD ACCEC DICDD ACCEC DICDD DICDD ACCEC DICDD DICDD DICDD ACCEC DICDD DICDD DICDD DICDD DICDD DICDD DICDD DICDD DICDD DICDD DICDD DICDD DICDD DICDD DICDD DICDD 
AAAAA BDAFD GFDHH HBEGC FIHHF EJAHD BDACH IEFIG AAJAH JADEF BEJFJ FACDD CBDHC GCBCG EGFGG BEJFJ FACDD AAADJ EIBJA HEGBJ AHFIJ IADDJ FEGAH EJHAE BDJJI AAJAH JADEF AFIIA BEJFJ FACDD JEJHH IEDFA FCHAD ACIJF DJBAC HCHIB DFIAJ HGGED AFGBI HIDBD AAJAH JADEF AFIIA BEJFJ FACDD AIBBH GBEFD JEIFC BIHGF CBFGA IIEDE
GBEFD: JEIFC
JEIFC: BIHGF
AFGBI: HIDBD
EGFGG: BEJFJ
DFIAJ: HGGED
AAJAH: JADEF,JADEF,JADEF
AAJAH AAJAH JADEF AAJAH AAJAH AAJAH AAJAH JADEF AAJAH JADEF AAJAH JADEF AAJAH AAJAH JADEF AAJAH JADEF AAJAH AAJAH AAJAH AAJAH AAJAH AAJAH AAJAH AAJAH AAJAH AAJAH JADEF AAJAH JADEF AAJAH AAJAH JADEF AAJAH AAJAH JADEF AAJAH JADEF AAJAH AAJAH AAJAH JADEF AAJAH AAJAH AAJAH AAJAH AAJAH AAJAH JADEF AAJAH 
AAAAA GHIHJ BEABF JHJIG GJBDD HAJJI DDFJA BCJFC AAEAH BHHJG CJAHG EAAGB IEJHB AIFCE FHECB GHCCB HAEHG CHEAA ABEEH CDFJG BBFDA EHFAI DECDF CJAHG BAGEI EAAGB IEJHB DCEDI IBABJ DHIFC FCHAJ GJGFG GHBBI IAGIA DEECF IEFAC BJIIA EAAGB IEJHB IJIIA EBEBJ DHDDH FFBJI DHCJG GAFBA DGDGB CBDEB FABFC BHHJG CJAHG BAGEI
HAJJI: DDFJA
FHECB: GHCCB
ABEEH: CDFJG
IEJHB: AIFCE,DCEDI,IJIIA
EBEBJ: DHDDH
JHJIG: GJBDD
BAGEI: EAAGB
AIFCE: FHECB
CJAHG: EAAGB,BAGEI,BAGEI
CHEAA: ABEEH
BJIIA: EAAGB
DHCJG: GAFBA
CBDEB: FABFC
AAEAH: BHHJG
EHFAI: DECDF
BEABF: JHJIG
DCEDI: IBABJ
BBFDA: EHFAI
GHCCB: HAEHG
IAGIA: DEECF
IJIIA: EBEBJ
IEFAC: BJIIA
DHIFC: FCHAJ
BHHJG: CJAHG,CJAHG
BHHJG BHHJG BHHJG BHHJG BHHJG BHHJG BHHJG BHHJG BHHJG BHHJG BHHJG BHHJG BHHJG BHHJG BHHJG CJAHG BHHJG BHHJG CJAHG BHHJG BHHJG BHHJG BHHJG BHHJG BHHJG BHHJG BHHJG BHHJG BHHJG BHHJG BHHJG BHHJG BHHJG BHHJG CJAHG BHHJG CJAHG BHHJG BHHJG BHHJG BHHJG BHHJG CJAHG BHHJG CJAHG BHHJG CJAHG BHHJG CJAHG BHHJG 
AAAAA ICJGE JFICC JCCBB CDFDD BGIGB JDHBB GFIAH IJAFE JEIFB JAFEA FBBJD GJHGB ICFGI JHDEG AFFDJ CEAJD CAGFC AJADA JBBIC DIJAG DBIBD DCHFI BFFJI IFHBC DHFCF HFDCJ JABJG JAFEA FBBJD GJHGB ABHHI IAIAH IHBBE CGFFF BJHDE EFAED AEIDE EEIFH BBCHG IBHGE DCJIH AGHIC CFIGE JAGJC CHEJG FBBJD GJHGB CDEJB AJHDA CHICE
BGIGB: JDHBB
GFIAH: IJAFE
JHDEG: AFFDJ
JEIFB: JAFEA
ICJGE: JFICC
HFDCJ: JABJG
DBIBD: DCHFI
BBCHG: IBHGE
DCJIH: AGHIC
EEIFH: BBCHG
CDFDD: BGIGB
JFICC: JCCBB
IFHBC: DHFCF
CEAJD: CAGFC
FBBJD: GJHGB,GJHGB,GJHGB
FBBJD GJHGB FBBJD GJHGB FBBJD GJHGB FBBJD GJHGB FBBJD GJHGB FBBJD GJHGB FBBJD GJHGB FBBJD GJHGB FBBJD GJHGB FBBJD GJHGB FBBJD GJHGB FBBJD GJHGB FBBJD GJHGB FBBJD GJHGB FBBJD GJHGB FBBJD GJHGB FBBJD GJHGB FBBJD GJHGB FBBJD GJHGB FBBJD GJHGB FBBJD GJHGB FBBJD GJHGB FBBJD GJHGB FBBJD GJHGB FBBJD GJHGB 
AAAAA GIJGH JFJEA CJCCB GGHDH AEGIH AGGIJ AEFGB GBEFF FJAGG FGBGB FJFAA HBGHI AGEJC AIJHB DJIAF AEGIH AGGIJ DIGJC GJCEG HBIJE GAEJD AHAEA BGAJB GBBCJ FAHAC EFFDC IJDDH HIAHG DJIAF HBGCG AEGIH AGGIJ BADBD HGHBH DAJGC EJGIF EGIBI GADHI HHGFH AIBEH HDGAG FACGD EAFGF DJIAF AEGIH AGGIJ CBGJF EEGJD HCAJH EDFGB
GBEFF: FJAGG
HBIJE: GAEJD
BADBD: HGHBH
CJCCB: GGHDH
EGIBI: GADHI
GGHDH: AEGIH
GJCEG: HBIJE
EEGJD: HCAJH
EAFGF: DJIAF
AHAEA: BGAJB
AEFGB: GBEFF
JFJEA: CJCCB
EDFGB: 
HGHBH: DAJGC
FACGD: EAFGF
DAJGC: EJGIF
HCAJH: EDFGB
AGGIJ: AEFGB,DIGJC,BADBD,CBGJF
HIAHG: DJIAF
HHGFH: AIBEH
HBGCG: AEGIH
AIBEH: HDGAG
AIJHB: DJIAF
GIJGH: JFJEA
HDGAG: FACGD
CBGJF: EEGJD
AEGIH: AGGIJ,AGGIJ,AGGIJ,AGGIJ
AEGIH AGGIJ AEGIH AGGIJ AEGIH AGGIJ AEGIH AGGIJ AEGIH AGGIJ AEGIH AGGIJ AEGIH AGGIJ AEGIH AGGIJ AEGIH AGGIJ AEGIH AGGIJ AEGIH AGGIJ AEGIH AGGIJ AEGIH AGGIJ AEGIH AGGIJ AEGIH AGGIJ AEGIH AGGIJ AEGIH AGGIJ AEGIH AGGIJ AEGIH AGGIJ AEGIH AGGIJ AEGIH AGGIJ AEGIH AGGIJ AEGIH AGGIJ AEGIH AGGIJ AEGIH AGGIJ 
AAAAA EAIHH EJEHG BIEAJ CHAJE GABAI DAHBA JBIEF JHEFI FDFJI JBAFC FCHEE CEGBG EEBDB EFFDD HFDIF EBJDE HBAEB GAICJ JBIEF JHEFI GFEHD BCABI GADFA GADIF HFFJH IEAIE BICGG HGJGF ABCFB JBIEF JHEFI CBJJB JJEJJ IJDJJ JEHDB FGHDF JEGHE DJCJH BGDFI HBAEB GAICJ JBIEF JHEFI BCJJF JHAEC ICFAB FDIGA EDBHE GBBEG EFGBE
GABAI: DAHBA
JBIEF: JHEFI,JHEFI,JHEFI,JHEFI
JBIEF JHEFI JBIEF JHEFI JBIEF JHEFI JBIEF JHEFI JBIEF JHEFI JBIEF JHEFI JBIEF JHEFI JBIEF JHEFI JBIEF JHEFI JBIEF JHEFI JBIEF JHEFI JBIEF JHEFI JBIEF JHEFI JBIEF JHEFI JBIEF JHEFI JBIEF JHEFI JBIEF JHEFI JBIEF JHEFI JBIEF JHEFI JBIEF JHEFI JBIEF JHEFI JBIEF JHEFI JBIEF JHEFI JBIEF JHEFI JBIEF JHEFI 
AAAAA AFEDA JEAGA DGJBC JAJHI EGCDH IGIEE FBJDG ADDIH ABJJJ DJJHA GEAFC AGFCI CHAIA FABHI EGGEJ FIAHF HGEHH GBFDF HEGAE CDDHI DHFIE FJFBI CHAIA FABHI DBEGC AIHJF HBFFJ GDGFA DCHAB DJJHA AEBEE FJFBI CHAIA FABHI GFJEC HDIIG IICCI GCCBA JCIII HIDDB GAHFJ FFGJG CJCFI AHHII IIGJD AEBEE AGFCI CHAIA FABHI FABGE
DBEGC: AIHJF
HEGAE: CDDHI
GFJEC: HDIIG
DGJBC: JAJHI
CJCFI: AHHII
HGEHH: GBFDF
FBJDG: ADDIH
DHFIE: FJFBI
AEBEE: FJFBI,AGFCI
AGFCI: CHAIA,CHAIA
AGFCI AGFCI AGFCI AGFCI AGFCI AGFCI AGFCI AGFCI CHAIA AGFCI CHAIA AGFCI AGFCI CHAIA AGFCI AGFCI AGFCI AGFCI AGFCI CHAIA AGFCI CHAIA AGFCI AGFCI AGFCI CHAIA AGFCI CHAIA AGFCI CHAIA AGFCI CHAIA AGFCI AGFCI CHAIA AGFCI CHAIA AGFCI AGFCI AGFCI CHAIA AGFCI AGFCI CHAIA AGFCI CHAIA AGFCI AGFCI AGFCI CHAIA 
AAAAA DBHEG AADEA IAABC CHFCF HFIAI FGDJB JFGAD CAGIC HCIJJ GJIAF EDAHF GFJEH CDIBJ EBGCF JCIDF IDJFG DFDGC ABIIF CCBEB AGGEI HFIAI FGDJB JFGAD AJDDF HDEDC DDCHG EHJIB EHADG FABJA ACEEH DBECE FIHJH AFGAD IGABJ BHDGA FGDJB JFGAD IDAED GBDCF DCIBA ACGBJ IHCBD IHAII HBGBI EHBAJ FGDJB JFGAD EAICH ACEAB CEAJH
CHFCF: HFIAI
DBHEG: AADEA
AGGEI: HFIAI
ACEEH: DBECE
AADEA: IAABC
ACGBJ: IHCBD
AFGAD: IGABJ
FIHJH: AFGAD
DBECE: FIHJH
HCIJJ: GJIAF
GBDCF: DCIBA
CEAJH: 
IDJFG: DFDGC
EBGCF: JCIDF
IHCBD: IHAII
HDEDC: DDCHG
ABIIF: CCBEB
EHADG: FABJA
IAABC: CHFCF
EAICH: ACEAB
IHAII: HBGBI
HBGBI: EHBAJ
EHBAJ: FGDJB
JCIDF: IDJFG
DCIBA: ACGBJ
FGDJB: JFGAD,JFGAD,JFGAD,JFGAD
FGDJB AAAAA FGDJB AAAAA FGDJB AAAAA FGDJB AAAAA FGDJB AAAAA FGDJB AAAAA FGDJB AAAAA FGDJB AAAAA FGDJB AAAAA FGDJB AAAAA FGDJB AAAAA FGDJB AAAAA FGDJB AAAAA FGDJB AAAAA FGDJB AAAAA FGDJB AAAAA FGDJB AAAAA FGDJB AAAAA FGDJB AAAAA FGDJB AAAAA FGDJB AAAAA FGDJB AAAAA FGDJB AAAAA FGDJB AAAAA FGDJB AAAAA 
AAAAA HCADI GFGBB HJBCI FEFCD FFAGI EBEFC AEHJH CCAAA GDCDA DJCJH GIAEA JIJII HBEEI DHEHJ CDGIB CABEI BFGJI BHFFH CFEDI AEAHA HBJFD GJCHG IGIBF AFGIB HBGGI DHEHJ CDGIB FGCGH FEADA JFFAH BFDIJ JDHIB DJADD FDJBF AFGIB DGDEJ JIJII HBEEI DHEHJ CDGIB DJEFF HJFCG GIBJC JICBJ EHBGF HAFJI ICEEA HFDGG CCAGH FFDJH
FEFCD: FFAGI
HJFCG: GIBJC
DGDEJ: JIJII
AEHJH: CCAAA
GDCDA: DJCJH
BHFFH: CFEDI
CFEDI: AEAHA
GJCHG: IGIBF
FEADA: JFFAH
JFFAH: BFDIJ
AEAHA: HBJFD
FFDJH: 
DJCJH: GIAEA
GFGBB: HJBCI
HBEEI: DHEHJ,DHEHJ
HBEEI AAAAA HBEEI HBEEI HBEEI AAAAA HBEEI HBEEI HBEEI AAAAA HBEEI AAAAA HBEEI AAAAA HBEEI HBEEI AAAAA HBEEI HBEEI AAAAA HBEEI AAAAA HBEEI AAAAA HBEEI HBEEI HBEEI HBEEI AAAAA HBEEI AAAAA HBEEI AAAAA HBEEI AAAAA HBEEI AAAAA HBEEI HBEEI AAAAA HBEEI HBEEI AAAAA HBEEI HBEEI AAAAA HBEEI HBEEI HBEEI HBEEI 
AAAAA HGFBH BIECC CJFAJ CEEJG EIIEJ IHCEB FGFAG CDEBA DFJBH ABFHA GBJGG HIGDJ EIDED JABBD JBIJD FAIDI AJHHD EBECA GJIEB DHBEG DFJBH GBJGG HIGDJ CEAIH IAJIF FCABB ABGJE EHCHC IGFEA DFJBH ABFHA HADFI GBJGG HIGDJ EBABE DAEDC EBCFA HIABC GGAHI HGFCA FAACB HADCI ADBEG CJHJE IBEBC DEJDA HADFI GBJGG HIGDJ IIJIA
DFJBH: ABFHA,GBJGG,ABFHA
GGAHI: HGFCA
CEEJG: EIIEJ
HIGDJ: EIDED,CEAIH,EBABE,IIJIA
HADCI: ADBEG
JBIJD: FAIDI
CJFAJ: CEEJG
HGFCA: FAACB
EBECA: GJIEB
IIJIA: 
HGFBH: BIECC
GBJGG: HIGDJ,HIGDJ,HIGDJ,HIGDJ
GBJGG AAAAA GBJGG AAAAA GBJGG AAAAA GBJGG AAAAA GBJGG AAAAA GBJGG AAAAA GBJGG AAAAA GBJGG AAAAA GBJGG AAAAA GBJGG AAAAA GBJGG AAAAA GBJGG AAAAA GBJGG AAAAA GBJGG AAAAA GBJGG AAAAA GBJGG AAAAA GBJGG AAAAA GBJGG AAAAA GBJGG AAAAA GBJGG AAAAA GBJGG AAAAA GBJGG AAAAA GBJGG AAAAA GBJGG AAAAA GBJGG AAAAA 
AAAAA DAHDE FDJFJ EJAGI AJGBI BACFB DBIJE ADEBH BHIBI EDEFG IEDIJ ABEIJ CDCIB CGGEJ EFFFH BDJHB HEDHG FICDB JJCHG IAAFF CIGJE IHIDA AEGCI CJICJ HHJCI EFFFH BDJHB EAJJE BFDIF BEEEI BBFBH JHAFD EBCIG BFEAI EIHFD CCEIJ BAIGJ ICGDE HHJCI IEDCD EFFFH BDJHB JJFDF JEBBF HEDBI JAEHG HBDCH HIBHH AHHBC CCEBI IDDHA
IEDIJ: ABEIJ
BACFB: DBIJE
CGGEJ: EFFFH
IHIDA: AEGCI
CJICJ: HHJCI
HBDCH: HIBHH
AJGBI: BACFB
EDEFG: IEDIJ
HEDHG: FICDB
CCEBI: IDDHA
EFFFH: BDJHB,BDJHB,BDJHB
EFFFH AAAAA EFFFH AAAAA EFFFH AAAAA EFFFH AAAAA EFFFH AAAAA EFFFH AAAAA EFFFH AAAAA EFFFH AAAAA EFFFH AAAAA EFFFH AAAAA EFFFH AAAAA EFFFH AAAAA EFFFH AAAAA EFFFH AAAAA EFFFH AAAAA EFFFH AAAAA EFFFH AAAAA EFFFH AAAAA EFFFH AAAAA EFFFH AAAAA EFFFH AAAAA EFFFH AAAAA EFFFH AAAAA EFFFH AAAAA EFFFH AAAAA 
AAAAA BICJG GCAJB JGADC FICFF AACFG DDGAG EHCFE BBBIC FIJCG BHBID HBHFC EBFJI HHFHF EABJA BAHAI EHIJI DJHHJ CHBGJ DFJBJ CEHDB IBACE HHHAF AJJGC HGEIJ IBHFF EABJA BAHAI BJGGD BEIJJ JBFBA IGCJI BCIHG DBAEC CCBHD JABAD FIEED DAHHB EBFJI IBHFF HHFHF EABJA BAHAI JACCC GIJFC CDHEJ GHGCG HHCBG CJJHC CHJFA BAHJD
CDHEJ: GHGCG
DFJBJ: CEHDB
EHIJI: DJHHJ
DDGAG: EHCFE
GCAJB: JGADC
EHCFE: BBBIC
BHBID: HBHFC
HBHFC: EBFJI
EBFJI: HHFHF,IBHFF
BAHAI: EHIJI,BJGGD,JACCC
BAHJD: 
JBFBA: IGCJI
HHHAF: AJJGC
AJJGC: HGEIJ
IBACE: HHHAF
DBAEC: CCBHD
IBHFF: EABJA,HHFHF
CEHDB: IBACE
HHCBG: CJJHC
DJHHJ: CHBGJ
GHGCG: HHCBG
GIJFC: CDHEJ
FICFF: AACFG
BJGGD: BEIJJ
JGADC: FICFF
HGEIJ: IBHFF
FIJCG: BHBID
IGCJI: BCIHG
BEIJJ: JBFBA
AACFG: DDGAG
HHFHF: EABJA,EABJA
HHFHF HHFHF HHFHF HHFHF AAAAA HHFHF AAAAA HHFHF HHFHF AAAAA HHFHF AAAAA HHFHF HHFHF AAAAA HHFHF AAAAA HHFHF AAAAA HHFHF HHFHF HHFHF HHFHF HHFHF HHFHF HHFHF AAAAA HHFHF AAAAA HHFHF AAAAA HHFHF AAAAA HHFHF AAAAA HHFHF HHFHF HHFHF HHFHF HHFHF HHFHF AAAAA HHFHF HHFHF HHFHF AAAAA HHFHF AAAAA HHFHF HHFHF 
AAAAA FHHAA CJCFA GBFJA ACFGJ ABBFI GHGBI DJBAE GBJBH GIECG JFJJC IDEIE GJAIH CHBID ADHDA GBJBH GIECG HJIDC GDIGE JJDFB BHBHA CCGBF DCJEG CHBID ADHDA GBJBH GIECG BEABH HBHJI IDDGB IGCBA HGBHH CDHHC BHHBJ FIFDD JBCDG CGFBC CHBID GBJBH GIECG FDHFJ GAAIH BGEJJ JFAJD HFFDG AGAFF HEEDC BGBFG EDFAI ABFEI GBJBH
DCJEG: CHBID
AGAFF: HEEDC
HEEDC: BGBFG
GJAIH: CHBID
HGBHH: CDHHC
ACFGJ: ABBFI
CCGBF: DCJEG
JBCDG: CGFBC
HFFDG: AGAFF
CDHHC: BHHBJ
CGFBC: CHBID
FIFDD: JBCDG
BEABH: HBHJI
IDDGB: IGCBA
FHHAA: CJCFA
FDHFJ: GAAIH
HJIDC: GDIGE
CJCFA: GBFJA
IGCBA: HGBHH
ABFEI: GBJBH
GAAIH: BGEJJ
BHHBJ: FIFDD
JJDFB: BHBHA
CHBID: ADHDA,ADHDA,GBJBH
DJBAE: GBJBH
GDIGE: JJDFB
EDFAI: ABFEI
IDEIE: GJAIH
BGEJJ: JFAJD
HBHJI: IDDGB
GBJBH: GIECG,GIECG,GIECG,GIECG
AAAAA GBJBH AAAAA GBJBH AAAAA GBJBH AAAAA GBJBH AAAAA GBJBH AAAAA GBJBH AAAAA GBJBH AAAAA GBJBH AAAAA GBJBH AAAAA GBJBH AAAAA GBJBH AAAAA GBJBH AAAAA GBJBH AAAAA GBJBH AAAAA GBJBH AAAAA GBJBH AAAAA GBJBH AAAAA GBJBH AAAAA GBJBH AAAAA GBJBH AAAAA GBJBH AAAAA GBJBH AAAAA GBJBH AAAAA GBJBH AAAAA GBJBH 
AAAAA FEJHD DBCHH BEHJC CIIAH CJAID CBAGG BFIJF AHFHD GCJEJ AEDIB EEGHH DEFHG ADHEG HJAGJ HEIBA IJBIB GAFJC IIFBA JGJAI HGIHI GCJEJ AEDIB GDBHB HAJDH ADJGI AGAIE IECFA BIHBI CBIFD JBHAA AHFHD GCJEJ AEDIB GHDDD IGAIB FJGDI AEDAH FDJGH GDHFA EDGFA CEHCG EGGFF BGBAC IFIFC HIICA GCJEJ AEDIB GCAGI BBDGG BEHIB
GDHFA: EDGFA
BEHIB: 
BFIJF: AHFHD
BIHBI: CBIFD
FDJGH: GDHFA
FJGDI: AEDAH
DEFHG: ADHEG
CIIAH: CJAID
IJBIB: GAFJC
DBCHH: BEHJC
CBIFD: JBHAA
EDGFA: CEHCG
HIICA: GCJEJ
EEGHH: DEFHG
CEHCG: EGGFF
BGBAC: IFIFC
EGGFF: BGBAC
IECFA: BIHBI
HEIBA: IJBIB
AEDIB: EEGHH,GDBHB,GHDDD,GCAGI
HGIHI: GCJEJ
JGJAI: HGIHI
IIFBA: JGJAI
JBHAA: AHFHD
GAFJC: IIFBA
BEHJC: CIIAH
GCJEJ: AEDIB,AEDIB,AEDIB,AEDIB
GCJEJ AAAAA GCJEJ AAAAA GCJEJ AAAAA GCJEJ AAAAA GCJEJ AAAAA GCJEJ AAAAA GCJEJ AAAAA GCJEJ AAAAA GCJEJ AAAAA GCJEJ AAAAA GCJEJ AAAAA GCJEJ AAAAA GCJEJ AAAAA GCJEJ AAAAA GCJEJ AAAAA GCJEJ AAAAA GCJEJ AAAAA GCJEJ AAAAA GCJEJ AAAAA GCJEJ AAAAA GCJEJ AAAAA GCJEJ AAAAA GCJEJ AAAAA GCJEJ AAAAA GCJEJ AAAAA 
AAAAA JCDIF GFEBB FDCCF JACIH GFJDA ADHDI AGDJG ABFFG FHFJI EDHGH FEBGJ JGBFH DDIHA IFBBE ACBBF EDEEI GACDA FJBFA FGABI IJEEH IJFJF BBIGD DIGHD AJEJH JFDGI BCJCE DCHAI DIEIB BDDIF HEFFC AGHDF EDEEI DJHEG AJBED CHCCJ FGABI IJEEH JEIAI EBACF IGHCG CGCEH HJHAH FCAAI DDHJF BFEFJ FJHGG FJBFA FGABI IJEEH FABIC
FJBFA: FGABI,FGABI
FJBFA FJBFA FJBFA FJBFA AAAAA FJBFA FJBFA FJBFA FJBFA AAAAA FJBFA FJBFA AAAAA FJBFA AAAAA FJBFA FJBFA AAAAA FJBFA FJBFA FJBFA FJBFA FJBFA FJBFA FJBFA FJBFA FJBFA AAAAA FJBFA AAAAA FJBFA AAAAA FJBFA AAAAA FJBFA FJBFA FJBFA FJBFA AAAAA FJBFA FJBFA AAAAA FJBFA FJBFA AAAAA FJBFA FJBFA FJBFA FJBFA FJBFA 
AAAAA JGAFG ADCJH HJJEH DHJBI AIDGI EIEAA HDHGB IJJEF DACAA DFDCI FCEJH GFBFC AIGEH DJJCE DBBGD HBIFA IDIFF BGDJA HCCGJ HJDBI CGFDA EGGCG AJEAF FCEJH GFBFC HIIHC IDHJG HGHJI HEAAA GCCBG EAAIG EIIFD DEEJG DACAA DFDCI FCEJH GFBFC BBEGA DIAJG BJDAC AICCH DAHCB BGHEG CAEEG HAJEF AHBJB DDHJA ACBBA EGGCG FCEJH
IDIFF: BGDJA
HDHGB: IJJEF
IDHJG: HGHJI
DACAA: DFDCI,DFDCI
DACAA AAAAA DACAA AAAAA DACAA AAAAA DACAA AAAAA DACAA AAAAA DACAA DACAA AAAAA DACAA AAAAA DACAA DACAA AAAAA DACAA AAAAA DACAA DACAA AAAAA DACAA DACAA DACAA AAAAA DACAA DACAA DACAA AAAAA DACAA DACAA DACAA AAAAA DACAA AAAAA DACAA DACAA DACAA AAAAA DACAA DACAA AAAAA DACAA DACAA AAAAA DACAA DACAA AAAAA 
AAAAA HDGEA IHCGB JHHJE HEFDC IGICH HFFCF JHEGD GBGHD CJDGB ACEDF AFJHI FBCIE FHHBA BEICF FFHJE EGEBH AJIDI BBIEB AGBED CBIEB HJEIH EJCCB IEGJI JBDFG IEGFI BAJAB EECGE EEDGD EGEBH AJIDI AFBCJ FDEAD BBHAI HCAIH JBFJG CFHJH GDGFI EFFIE JGCAG HAEBI JDICG EACDD FBGAD GICFB FIJAE EAFIA EGEBH AJIDI JEFHD CEICI
JGCAG: HAEBI
GBGHD: CJDGB
HDGEA: IHCGB
HEFDC: IGICH
EACDD: FBGAD
HCAIH: JBFJG
FDEAD: BBHAI
CEICI: 
JHHJE: HEFDC
EECGE: EEDGD
FFHJE: EGEBH
CJDGB: ACEDF
AFBCJ: FDEAD
IHCGB: JHHJE
BEICF: FFHJE
GDGFI: EFFIE
EFFIE: JGCAG
IGICH: HFFCF
BBIEB: AGBED
EJCCB: IEGJI
BBHAI: HCAIH
GICFB: FIJAE
JEFHD: CEICI
CFHJH: GDGFI
FBCIE: FHHBA
FIJAE: EAFIA
JHEGD: GBGHD
JBFJG: CFHJH
BAJAB: EECGE
EEDGD: EGEBH
HJEIH: EJCCB
HAEBI: JDICG
EGEBH: AJIDI,AJIDI,AJIDI
EGEBH AAAAA EGEBH AAAAA EGEBH AAAAA EGEBH AAAAA EGEBH AAAAA EGEBH AAAAA EGEBH AAAAA EGEBH AAAAA EGEBH AAAAA EGEBH AAAAA EGEBH AAAAA EGEBH AAAAA EGEBH AAAAA EGEBH AAAAA EGEBH AAAAA EGEBH AAAAA EGEBH AAAAA EGEBH AAAAA EGEBH AAAAA EGEBH AAAAA EGEBH AAAAA EGEBH AAAAA EGEBH AAAAA EGEBH AAAAA EGEBH AAAAA 
AAAAA BAJJB BBEGC BDDIF AJADD BCCCF EGFDE IICJI BDEAF CCEIH HGHDB BCCJE GFHJF BABEB FIBHC ADGAA CECHA GIGJB HJJBF DBGAD AJADD EJHAE IICJI BDEAF HHCDI CFEJI GFJBG CIHAA DAHID ADCBC CIIBF HHHDG AEEBA AJADD DDACD IICJI BDEAF AACII ICJCA GDCJI IHJFC IGAGC BADHC JICEH GEHIH BCCCF EJHAE EGFDE IICJI BDEAF GGGJA
GGGJA: 
CECHA: GIGJB
ICJCA: GDCJI
BDDIF: AJADD
AACII: ICJCA
JICEH: GEHIH
ADGAA: CECHA
IHJFC: IGAGC
BCCJE: GFHJF
GEHIH: BCCCF
FIBHC: ADGAA
AEEBA: AJADD
GIGJB: HJJBF
IGAGC: BADHC
BAJJB: BBEGC
ADCBC: CIIBF
DDACD: IICJI
BCCCF: EGFDE,EJHAE
DBGAD: AJADD
HGHDB: BCCJE
BDEAF: CCEIH,HHCDI,AACII,GGGJA
HHCDI: CFEJI
HHHDG: AEEBA
GFJBG: CIHAA
EGFDE: IICJI,IICJI
EGFDE AAAAA EGFDE AAAAA EGFDE AAAAA EGFDE AAAAA EGFDE AAAAA EGFDE AAAAA EGFDE AAAAA EGFDE AAAAA EGFDE AAAAA EGFDE AAAAA EGFDE AAAAA EGFDE AAAAA EGFDE AAAAA EGFDE AAAAA EGFDE AAAAA EGFDE AAAAA EGFDE AAAAA EGFDE AAAAA EGFDE AAAAA EGFDE AAAAA EGFDE AAAAA EGFDE AAAAA EGFDE AAAAA EGFDE AAAAA EGFDE AAAAA 
AAAAA BHCHI HAJAC JBIIB HHBIE AAIGH JDBCE BHICD EGAJG EIDAI CFFIH EFBGG EICIF CEJAE GCJFA CGIEH GFDEI FHAEA FFHAB AIBEH JIGIA FDHHB CDHCA GCJFA CGIEH GFDEI BJJIJ EIFCE GDAJC BIGIF DGCAF IFAAH JFEFB CECJH HJDFD EICIF BEJBH CEJAE GCJFA CGIEH GFDEI JDHFG HACEE EDDHE AAGDD ADHII GDFGG AJJAJ CBCHC ADCAE HDHCH
BIGIF: DGCAF
BHCHI: HAJAC
EFBGG: EICIF
HAJAC: JBIIB
ADHII: GDFGG
HJDFD: EICIF
ADCAE: HDHCH
AAIGH: JDBCE
GFDEI: FHAEA,BJJIJ,JDHFG
CECJH: HJDFD
AIBEH: JIGIA
GDAJC: BIGIF
EIDAI: CFFIH
FFHAB: AIBEH
EGAJG: EIDAI
HDHCH: 
BEJBH: CEJAE
FDHHB: CDHCA
GCJFA: CGIEH,CGIEH,CGIEH
GCJFA AAAAA GCJFA AAAAA GCJFA AAAAA GCJFA AAAAA GCJFA AAAAA GCJFA AAAAA GCJFA AAAAA GCJFA AAAAA GCJFA AAAAA GCJFA AAAAA GCJFA AAAAA GCJFA AAAAA GCJFA AAAAA GCJFA AAAAA GCJFA AAAAA GCJFA AAAAA GCJFA AAAAA GCJFA AAAAA GCJFA AAAAA GCJFA AAAAA GCJFA AAAAA GCJFA AAAAA GCJFA AAAAA GCJFA AAAAA GCJFA AAAAA 
AAAAA ABBGD IDFHH EBEJA DIBFB EFFHI DBFHG DHJHG BAEFF EBBGF HAJCD FHGED BHBBH AFGIA BFICD CEIBJ CABBA CCEJJ DDCIE DBFHG JHCFE BBBFE ADFJC EBBGF HAJCD FGGBG EFDCJ GEIJH CHAIE GGIDB AHGAA EHEAJ HGCHG GJFHF DDCIE CIGFI BBBFE BIFIA BAEFF EBBGF HAJCD CABAD AFEIG IAADE EAFED CICDI ICDCF DIABJ CFAJE EJIIB AFDJD
CIGFI: BBBFE
EAFED: CICDI
BHBBH: AFGIA
DIBFB: EFFHI
ADFJC: EBBGF
GGIDB: AHGAA
HAJCD: FHGED,FGGBG,CABAD
BIFIA: BAEFF
BAEFF: EBBGF,EBBGF
BAEFF AAAAA BAEFF AAAAA BAEFF AAAAA BAEFF AAAAA BAEFF AAAAA BAEFF AAAAA BAEFF AAAAA BAEFF AAAAA BAEFF AAAAA BAEFF AAAAA BAEFF AAAAA BAEFF AAAAA BAEFF AAAAA BAEFF AAAAA BAEFF AAAAA BAEFF AAAAA BAEFF AAAAA BAEFF AAAAA BAEFF AAAAA BAEFF AAAAA BAEFF AAAAA BAEFF AAAAA BAEFF AAAAA BAEFF AAAAA BAEFF AAAAA 
AAAAA GGIHF IJBCI BCJEF DCEIF BDFHJ IHCEB FAHIC CAIDH GCGBD DCEIF BDFHJ DADDC CCFFI JGBCH ECDAA DJGDD FJAJG CHJFI BCJEF GCGBD DCEIF BDFHJ JDAAE BHFDC IAJHE GDICH BDFEI DIACD FFIFH DFEIF GJGIG DBFBC HJHIE ICBCI GCDFC DGHBC GHGIH CAEGA GHHBC DCEIF BDFHJ DEDFE BHEFD EACCH EGIHF CHJFI BCJEF DCEIF BDFHJ FAJAI
GGIHF: IJBCI
EGIHF: CHJFI
GDICH: BDFEI
CCFFI: JGBCH
BHFDC: IAJHE
DIACD: FFIFH
GHHBC: DCEIF
DBFBC: HJHIE
FJAJG: CHJFI
CAEGA: GHHBC
HJHIE: ICBCI
BDFHJ: IHCEB,DADDC,JDAAE,DEDFE,FAJAI
CAIDH: GCGBD
BDFEI: DIACD
FFIFH: DFEIF
FAJAI: 
IAJHE: GDICH
GCDFC: DGHBC
ECDAA: DJGDD
DJGDD: FJAJG
GCGBD: DCEIF,DCEIF
GCGBD AAAAA GCGBD AAAAA GCGBD AAAAA GCGBD AAAAA GCGBD AAAAA GCGBD AAAAA GCGBD AAAAA GCGBD AAAAA GCGBD AAAAA GCGBD AAAAA GCGBD AAAAA GCGBD AAAAA GCGBD AAAAA GCGBD AAAAA GCGBD AAAAA GCGBD AAAAA GCGBD AAAAA GCGBD AAAAA GCGBD AAAAA GCGBD AAAAA GCGBD AAAAA GCGBD AAAAA GCGBD AAAAA GCGBD AAAAA GCGBD AAAAA 
AAAAA HHCDI DDDHG HEHAI IAJAC HHDCA ADGIJ BIBII DJEGJ AGJGA AGIBF ICEFD GAJFH BCEGF AEJCE HFAGB BDECE EGEAH HHDCA ADGIJ JEIJB FCHEI BBBDB JDEFD EGEAH HHDCA ADGIJ DHDDD IIIHE AEFDF BAFAG EEFGB IJCEJ FCGIE CBDCD FIJAI BGFHB BDECE HHDCA ADGIJ BHAJD CEGCJ JCDIH IEFEA FHCFB EHAGG GGHFG GJJCA EGEAH HHDCA ADGIJ
GJJCA: EGEAH
JEIJB: FCHEI
HHDCA: ADGIJ,ADGIJ,ADGIJ,ADGIJ,ADGIJ
HHDCA AAAAA HHDCA AAAAA HHDCA AAAAA HHDCA AAAAA HHDCA AAAAA HHDCA AAAAA HHDCA AAAAA HHDCA AAAAA HHDCA AAAAA HHDCA AAAAA HHDCA AAAAA HHDCA AAAAA HHDCA AAAAA HHDCA AAAAA HHDCA AAAAA HHDCA AAAAA HHDCA AAAAA HHDCA AAAAA HHDCA AAAAA HHDCA AAAAA HHDCA AAAAA HHDCA AAAAA HHDCA AAAAA HHDCA AAAAA HHDCA AAAAA 
AAAAA EEBJI CDHFH BHFCG ADDFG AHFFE GJAIH JCDBF HCIGF DFFHC DFBFF JDBDG ABDIA BJFFF EAGAG BJDIA FAEIF IGDIF DFFHC GEFBG JDBDG ABDIA ACDCE FFJEF FIEDA ABDFE FEDHF AIFIE GDHBD IGEBE FDHBH FHBGJ JDCDJ HEFGH JIGDB HBIEH JDBDG ABDIA IDEHD HBCDI JHCFJ EGDEB IJFBG HCHJI JJBDE ICJIE FECJE ECDEF DEIBB AIFEI HECAH
ECDEF: DEIBB
BJDIA: FAEIF
IJFBG: HCHJI
HECAH: 
EAGAG: BJDIA
HBIEH: JDBDG
GJAIH: JCDBF
FECJE: ECDEF
GEFBG: JDBDG
FEDHF: AIFIE
AIFIE: GDHBD
FHBGJ: JDCDJ
DFBFF: JDBDG
ABDFE: FEDHF
ADDFG: AHFFE
AIFEI: HECAH
JDBDG: ABDIA,ABDIA,ABDIA
JDBDG AAAAA JDBDG AAAAA JDBDG AAAAA JDBDG AAAAA JDBDG AAAAA JDBDG AAAAA JDBDG AAAAA JDBDG AAAAA JDBDG AAAAA JDBDG AAAAA JDBDG AAAAA JDBDG AAAAA JDBDG AAAAA JDBDG AAAAA JDBDG AAAAA JDBDG AAAAA JDBDG AAAAA JDBDG AAAAA JDBDG AAAAA JDBDG AAAAA JDBDG AAAAA JDBDG AAAAA JDBDG AAAAA JDBDG AAAAA JDBDG AAAAA 
AAAAA FFCFJ EFGCF GCDCF JBCEC BCDFB JJIFI ACIHE CCEHG EDEAA AFIFF BDIAB AFJDJ JAAGA JEIDE GHJIE FDJIJ GCFBC CIECI GGABE EJEDB EDIFF GJEJA CJFBA HIAHH GJEEB JEIDE GHJIE HGGBD DDFCJ FFCIE IHCAA JEJGA ADFFG JECAI IJEFE BEHGF JEIDE GHJIE HEGGG EAFCF EHBHH GEIEB BDDFI IIGAC DDCJI IJEIE BEHCG FJEBJ HFAIA EJEFB
JAAGA: JEIDE
GEIEB: BDDFI
FFCFJ: EFGCF
GJEEB: JEIDE
AFIFF: BDIAB
HFAIA: EJEFB
HGGBD: DDFCJ
JEJGA: ADFFG
BDIAB: AFJDJ
IHCAA: JEJGA
FFCIE: IHCAA
GGABE: EJEDB
JECAI: IJEFE
BEHGF: JEIDE
CJFBA: HIAHH
EFGCF: GCDCF
IIGAC: DDCJI
DDCJI: IJEIE
EAFCF: EHBHH
CIECI: GGABE
JBCEC: BCDFB
ADFFG: JECAI
ACIHE: CCEHG
GJEJA: CJFBA
DDFCJ: FFCIE
CCEHG: EDEAA
FDJIJ: GCFBC
JEIDE: GHJIE,GHJIE,GHJIE
JEIDE AAAAA JEIDE AAAAA JEIDE AAAAA JEIDE AAAAA JEIDE AAAAA JEIDE AAAAA JEIDE AAAAA JEIDE AAAAA JEIDE AAAAA JEIDE AAAAA JEIDE AAAAA JEIDE AAAAA JEIDE AAAAA JEIDE AAAAA JEIDE AAAAA JEIDE AAAAA JEIDE AAAAA JEIDE AAAAA JEIDE AAAAA JEIDE AAAAA JEIDE AAAAA JEIDE AAAAA JEIDE AAAAA JEIDE AAAAA JEIDE AAAAA 
AAAAA DADDH EEDHH FJJDC EBIIA GEHIE FCGFF EBAFJ GBJEG DAFAB BCBGJ BFFFF FCDEB IHHBB AECCG JADGJ IHCDF AEEDG BIIIG GDJDE AICEC HCFGD DAEGD AEGIA CDEFC ADCHC GAJCG DAFAB FCDEB IHHBB JDEEJ AECCG JADGJ HEJIH HFHCI EBJCD FEGAH FEDCH ECACF ECIGD JAFAJ GACEJ GCIFH FCDEB AECCG JADGJ CHIFD IDDFF FHBBD BCHFB DIFFB
FHBBD: BCHFB
FCGFF: EBAFJ
AEEDG: BIIIG
GBJEG: DAFAB
ECIGD: JAFAJ
DADDH: EEDHH
GDJDE: AICEC
GEHIE: FCGFF
FEGAH: FEDCH
BIIIG: GDJDE
GACEJ: GCIFH
FJJDC: EBIIA
DAFAB: BCBGJ,FCDEB
FEDCH: ECACF
AECCG: JADGJ,JADGJ,JADGJ
AECCG AAAAA AECCG AAAAA AECCG AAAAA AECCG AAAAA AECCG AAAAA AECCG AAAAA AECCG AAAAA AECCG AAAAA AECCG AAAAA AECCG AAAAA AECCG AAAAA AECCG AAAAA AECCG AAAAA AECCG AAAAA AECCG AAAAA AECCG AAAAA AECCG AAAAA AECCG AAAAA AECCG AAAAA AECCG AAAAA AECCG AAAAA AECCG AAAAA AECCG AAAAA AECCG AAAAA AECCG AAAAA 
AAAAA AGBFE GEGJB IJHIE GDEGC GFCDI IJJJD EJEJI GFCIE EJJDD FFAFJ GCGGC FCDCE BDJCA GDEJA EDEFB FBEGJ JEBHB FBHCF IDHGC AAHJC GDBCI CJAAB FCDIG CDECE GFCIE EJJDD FFAFJ BCJHA HFJDB DIDJE DEDAG HBBBB AGJCA CEIFG BJICI GFCDI JGIJA DJAFC GFCIE EJJDD FFAFJ BFBJI BGFDJ HACAG FDFAE AGDJI JGJJC GIGJC GBFAE CDECE
BJICI: GFCDI
AGDJI: JGJJC
EJJDD: FFAFJ,FFAFJ,FFAFJ
EJJDD AAAAA EJJDD AAAAA EJJDD AAAAA EJJDD AAAAA EJJDD AAAAA EJJDD AAAAA EJJDD AAAAA EJJDD AAAAA EJJDD AAAAA EJJDD AAAAA EJJDD AAAAA EJJDD AAAAA EJJDD AAAAA EJJDD AAAAA EJJDD AAAAA EJJDD AAAAA EJJDD AAAAA EJJDD AAAAA EJJDD AAAAA EJJDD AAAAA EJJDD AAAAA EJJDD AAAAA EJJDD AAAAA EJJDD AAAAA EJJDD AAAAA 
AAAAA BJJDG JBCFC BECBB EJHDA EEADH CCHAE IEIIC CEFIG CDJED HEIBB BEJDA DJBJB CEDJD FCDDG CFAGF HJIFG JGEEG FJHCF FJAHD EHDFB HCAFJ FFIHF BEJDA FEJHH DBFIG ECJFH CEDJD FCDDG BIFEH HFJHG EAGHF EHEGH GDIJJ IEFJG EGCDE DBECE GJJII ECJFH CEDJD FCDDG IGAFG ACGGH GECJI HDACJ HJFBG DFHIJ FIIFD EIEAJ ABFAA JGHCA
DFHIJ: FIIFD
EEADH: CCHAE
ACGGH: GECJI
FIIFD: EIEAJ
ECJFH: CEDJD,CEDJD
ECJFH ECJFH ECJFH ECJFH ECJFH ECJFH ECJFH AAAAA ECJFH AAAAA ECJFH AAAAA ECJFH AAAAA ECJFH ECJFH ECJFH AAAAA ECJFH AAAAA ECJFH AAAAA ECJFH ECJFH AAAAA ECJFH AAAAA ECJFH AAAAA ECJFH AAAAA ECJFH ECJFH ECJFH AAAAA ECJFH AAAAA ECJFH AAAAA ECJFH ECJFH AAAAA ECJFH ECJFH AAAAA ECJFH ECJFH ECJFH AAAAA ECJFH 
AAAAA GAGCD AAEDD EFAJB EIAHF AFEBD HHHAA JGGJD DCAEC AHCIJ IGFJC BGIAJ FEJFG HGDIB JJGIA JFJGF DBJEH JEGCG EEIJE FFBBG CGADI FGIJC GCFGJ FEJFG HGDIB JBHHB ADGIH BJGAG HDJDG AAHHH AHBCC BAIBD DJJCB FBEHG AABBD CFGIG EHGEH BGIAJ GCFGJ FEJFG HGDIB FGHEG HIDCD BDJCG HCDJA DHIFE IFBAG DDGDJ HDGGI HECEG CAAIF
BDJCG: HCDJA
AFEBD: HHHAA
DCAEC: AHCIJ
AHCIJ: IGFJC
AAHHH: AHBCC
AABBD: CFGIG
HCDJA: DHIFE
DJJCB: FBEHG
GCFGJ: FEJFG,FEJFG
GCFGJ AAAAA GCFGJ AAAAA GCFGJ AAAAA GCFGJ AAAAA GCFGJ AAAAA GCFGJ AAAAA GCFGJ AAAAA GCFGJ AAAAA GCFGJ AAAAA GCFGJ AAAAA GCFGJ AAAAA GCFGJ AAAAA GCFGJ AAAAA GCFGJ AAAAA GCFGJ AAAAA GCFGJ AAAAA GCFGJ AAAAA GCFGJ AAAAA GCFGJ AAAAA GCFGJ AAAAA GCFGJ AAAAA GCFGJ AAAAA GCFGJ AAAAA GCFGJ AAAAA GCFGJ AAAAA 
AAAAA EJBAJ GCBDJ FDAAJ AAEHF CEJAI HAIAE EIJGI EJADA DCDDD CBIEE HHBHI BGCAI AEEJE IHDDE JFEII EGABH IGJAE BDDHE IIJFF EEFJJ HCEJF JBCCD BDIFJ GHGFF IHDDE JFEII EGABH AICEG CJBBB JACIE CBGFH FBEJH JCGHH GCJCG JHFDJ DHEED GHHFB JFGIA BGCAI FBHDJ JFEII EGABH DIAHD FJGDE ICJCE AHICI AICBH BJEDC DEJAD JGDFD
AICEG: CJBBB
JFGIA: BGCAI
GCBDJ: FDAAJ
JCGHH: GCJCG
JHFDJ: DHEED
DEJAD: JGDFD
BDDHE: IIJFF
CBIEE: HHBHI
BGCAI: AEEJE,FBHDJ
AHICI: AICBH
HAIAE: EIJGI
JACIE: CBGFH
ICJCE: AHICI
AEEJE: IHDDE
FDAAJ: AAEHF
JFEII: EGABH,EGABH,EGABH
JFEII AAAAA JFEII AAAAA JFEII AAAAA JFEII AAAAA JFEII AAAAA JFEII AAAAA JFEII AAAAA JFEII AAAAA JFEII AAAAA JFEII AAAAA JFEII AAAAA JFEII AAAAA JFEII AAAAA JFEII AAAAA JFEII AAAAA JFEII AAAAA JFEII AAAAA JFEII AAAAA JFEII AAAAA JFEII AAAAA JFEII AAAAA JFEII AAAAA JFEII AAAAA JFEII AAAAA JFEII AAAAA 
AAAAA DDCAB FEICH HFBDI AHJCA JDBJH EDGJH JGJJH CJHJH IGBAF AABFC EHDJJ FHJFG EDFDD FIJAB GCDCA ECABF HCJHI CJGFA IICCG FIDFI IGBAF DCFEA AABFC EHDJJ FHJFG BCBEC IACCF FHCBI HAFAF BHDEI EHDJJ FHJFG IEBJD CIICA AHEBE BGGFA HJCJA GGFGA ECAHH EIEFC CAFFA GJCHI HEDJE HCGFB IFEBI CJHJH DCFEA EHDJJ FHJFG GAHGD
DDCAB: FEICH
AABFC: EHDJJ,EHDJJ
AABFC AAAAA AABFC AAAAA AABFC AAAAA AABFC AAAAA AABFC AAAAA AABFC AAAAA AABFC AAAAA AABFC AAAAA AABFC AAAAA AABFC AAAAA AABFC AAAAA AABFC AAAAA AABFC AAAAA AABFC AAAAA AABFC AAAAA AABFC AAAAA AABFC AAAAA AABFC AAAAA AABFC AAAAA AABFC AAAAA AABFC AAAAA AABFC AAAAA AABFC AAAAA AABFC AAAAA AABFC AAAAA 
AAAAA AGIGH CJIAE IDDEE EAAEC DFEFJ IEIJH FBHCB IAFAJ FAHAE FBEBD FFAJF AAFJC IBDIA IDEAD CIDIF FHAJJ FCFAD FBHCB BHCJE IAFAJ FAHAE DJAEH JDJJE IHFGH CIDBF DDIFJ CCGAB CFGAC GDGEE BHCJE IAFAJ FAHAE DCDGA DFDJC EDEJE GAJCH JJFCF JHAAI ICDAD IDHGI FCFAD FBHCB IAFAJ FAHAE IAECF JCFFB IHEHF IGCDC IAHFD FHAJJ
IAFAJ: FAHAE,FAHAE,FAHAE,FAHAE
FAHAE IAFAJ AAAAA IAFAJ AAAAA IAFAJ AAAAA IAFAJ AAAAA IAFAJ AAAAA IAFAJ AAAAA IAFAJ AAAAA IAFAJ AAAAA IAFAJ AAAAA IAFAJ AAAAA IAFAJ AAAAA IAFAJ AAAAA IAFAJ AAAAA IAFAJ AAAAA IAFAJ AAAAA IAFAJ AAAAA IAFAJ AAAAA IAFAJ AAAAA IAFAJ AAAAA IAFAJ AAAAA IAFAJ AAAAA IAFAJ AAAAA IAFAJ AAAAA IAFAJ AAAAA IAFAJ 
AAAAA EBBFG HIIFF JAFJJ GJJEF FCECC JJECG AFCGG GFGAD DJBED AHFFJ CHHGD BCGED IJGEI BJEAG IHDII ABIEI FCECC JFHJC JHIAG HIIGG HJBAA GFGAD DJBED AHFFJ CAIFD EFIDF JFHFG JAGAC EJGDJ ADEGI DGBJH CAEAF ACHHC HCBJI GFJCD IAAJI AFCGG DJBED AHFFJ EFAIB FADBB IJGJC IFFHH EDGGE CCDFD EBEDC AAEIB CIHHI EGAFI ABBCH
JAFJJ: GJJEF
JAGAC: EJGDJ
JHIAG: HIIGG
HJBAA: GFGAD
CHHGD: BCGED
CIHHI: EGAFI
CAEAF: ACHHC
JFHJC: JHIAG
IFFHH: EDGGE
AFCGG: GFGAD,DJBED
GFJCD: IAAJI
IJGEI: BJEAG
ABBCH: 
JJECG: AFCGG
CCDFD: EBEDC
EDGGE: CCDFD
IHDII: ABIEI
JFHFG: JAGAC
EFAIB: FADBB
CAIFD: EFIDF
EFIDF: JFHFG
HIIFF: JAFJJ
ABIEI: FCECC
GFGAD: DJBED,DJBED
GFGAD AAAAA GFGAD AAAAA GFGAD AAAAA GFGAD AAAAA GFGAD AAAAA GFGAD AAAAA GFGAD AAAAA GFGAD AAAAA GFGAD AAAAA GFGAD AAAAA GFGAD AAAAA GFGAD AAAAA GFGAD AAAAA GFGAD AAAAA GFGAD AAAAA GFGAD AAAAA GFGAD AAAAA GFGAD AAAAA GFGAD AAAAA GFGAD AAAAA GFGAD AAAAA GFGAD AAAAA GFGAD AAAAA GFGAD AAAAA GFGAD AAAAA 
AAAAA ECJDI CEBGD BAADI IGAJF GEHIJ CGHBI FBADH IIDFI ECCDC BDCHG HJEHA JIJAD AJJGA HHHHB JJAIH HFCEE CFJIB FDGEG EIJDJ HBAJG CCAEA HGBEE DGBBA CGHBI IIDFI ECCDC FJIEG GICAG JCEEI HBHCJ JHFJD FJGDC AAAED GFDGC EAIBD CCDHH BGGHA EGFBA IIDFI ECCDC GCAGE FDHDB JEIDF JIBJB DJDCF HGGII ADDJF IIDFI ECCDC EHHCG
GICAG: JCEEI
FDGEG: EIJDJ
HGGII: ADDJF
EIJDJ: HBAJG
HBHCJ: JHFJD
FJIEG: GICAG
BAADI: IGAJF
CFJIB: FDGEG
CCDHH: BGGHA
JHFJD: FJGDC
FBADH: IIDFI
HJEHA: JIJAD
ECJDI: CEBGD
AJJGA: HHHHB
HBAJG: CCAEA
JEIDF: JIBJB
EGFBA: IIDFI
HHHHB: JJAIH
ECCDC: BDCHG,FJIEG,GCAGE,EHHCG
BDCHG: HJEHA
IIDFI: ECCDC,ECCDC,ECCDC,ECCDC
IIDFI AAAAA IIDFI AAAAA IIDFI AAAAA IIDFI AAAAA IIDFI AAAAA IIDFI AAAAA IIDFI AAAAA IIDFI AAAAA IIDFI AAAAA IIDFI AAAAA IIDFI AAAAA IIDFI AAAAA IIDFI AAAAA IIDFI AAAAA IIDFI AAAAA IIDFI AAAAA IIDFI AAAAA IIDFI AAAAA IIDFI AAAAA IIDFI AAAAA IIDFI AAAAA IIDFI AAAAA IIDFI AAAAA IIDFI AAAAA IIDFI AAAAA 
AAAAA GIEGG IGCAC BHJDF CHAAC FCJDF JFIAI BEDBC BJEJE BHADF DDGFD GJBJG EGIAA FFIFH DBFFE CCFDH AIFEE GDBJI JHJFA HIJGE JGJCC EHBAB FBEGF EGIAA FFIFH EDHGA EIDJB GABFE IABJI EDBIE IFDHG CIHFA EGIAA FFIFH DHDEH CCJCB DIFFB JEBCI EHGAI EBAGJ GFFAD GHIFB FDFII DGBHG FGJGA EGIAA FFIFH CGIDG GHHGF HHIGF DJBDE
FBEGF: EGIAA
GABFE: IABJI
EIDJB: GABFE
AIFEE: GDBJI
CGIDG: GHHGF
CHAAC: FCJDF
BEDBC: BJEJE
CIHFA: EGIAA
CCJCB: DIFFB
FGJGA: EGIAA
CCFDH: AIFEE
GFFAD: GHIFB
EDBIE: IFDHG
DBFFE: CCFDH
GIEGG: IGCAC
FFIFH: DBFFE,EDHGA,DHDEH,CGIDG
DDGFD: GJBJG
BHADF: DDGFD
EGIAA: FFIFH,FFIFH,FFIFH,FFIFH
EGIAA AAAAA EGIAA AAAAA EGIAA AAAAA EGIAA AAAAA EGIAA AAAAA EGIAA AAAAA EGIAA AAAAA EGIAA AAAAA EGIAA AAAAA EGIAA AAAAA EGIAA AAAAA EGIAA AAAAA EGIAA AAAAA EGIAA AAAAA EGIAA AAAAA EGIAA AAAAA EGIAA AAAAA EGIAA AAAAA EGIAA AAAAA EGIAA AAAAA EGIAA AAAAA EGIAA AAAAA EGIAA AAAAA EGIAA AAAAA EGIAA AAAAA 
AAAAA CIJFH GIDID BDIBE BDFIH DAAGE JHHGE HHGJC GIGEE GIAFH CEADE CGJFA IADCE EIJHJ CEGEB HBFEF IBBCG BCBCA EHDCC DGBHB BDEGF JHHGE AHDFH GGFIE BJDGA GIAFH CEADE HAIHH HHCEA EBCHB IACAD IEBCE HIJHF DCHGD JCCDE DCECJ GGFIE GIAFH CEADE CAADC EEJBB FAIAH EEFEI JDAHG EAIJI AIEEH GIGEE GIAFH CEADE CCBFH BFIJH
BCBCA: EHDCC
GIGEE: GIAFH,GIAFH
GIGEE AAAAA GIGEE GIGEE AAAAA GIGEE GIGEE AAAAA GIGEE AAAAA GIGEE AAAAA GIGEE GIGEE GIGEE GIGEE GIGEE AAAAA GIGEE GIGEE AAAAA GIGEE AAAAA GIGEE AAAAA GIGEE GIGEE AAAAA GIGEE GIGEE GIGEE GIGEE GIGEE GIGEE AAAAA GIGEE AAAAA GIGEE AAAAA GIGEE GIGEE AAAAA GIGEE GIGEE GIGEE AAAAA GIGEE AAAAA GIGEE AAAAA 
AAAAA EJBFC GHBGH FCDIG GFGDB ECEFB CAFDJ FEBAD GAAGC AHEHJ HIFJA BEEJF FFIED EFHJA CJAEG IDFBD HGHFD BABAD ADIIG IFBEF EAAFB GAAGC AHEHJ IAIGE IGEIF EECAE FAJGG IDEGD DAFCB IFBEF HAGFF GAAGC AHEHJ FFCHA EBIEF BJJBE CAGBC DFCGJ CCECB HHDAB HAGCG AJBHA GAAGC AHEHJ EGAGF CFEEH HHAAI FAEAA CCFAD GCDHD JDBAJ
BJJBE: CAGBC
HAGFF: GAAGC
IGEIF: EECAE
EGAGF: CFEEH
EJBFC: GHBGH
GHBGH: FCDIG
HIFJA: BEEJF
CCFAD: GCDHD
CAFDJ: FEBAD
IFBEF: EAAFB,HAGFF
ADIIG: IFBEF
IDEGD: DAFCB
JDBAJ: 
DAFCB: IFBEF
FAJGG: IDEGD
CFEEH: HHAAI
FCDIG: GFGDB
EAAFB: GAAGC
HHAAI: FAEAA
FFCHA: EBIEF
HAGCG: AJBHA
FEBAD: GAAGC
FAEAA: CCFAD
CJAEG: IDFBD
AJBHA: GAAGC
IDFBD: HGHFD
GFGDB: ECEFB
EFHJA: CJAEG
BEEJF: FFIED
IAIGE: IGEIF
ECEFB: CAFDJ
EBIEF: BJJBE
DFCGJ: CCECB
HGHFD: BABAD
BABAD: ADIIG
GAAGC: AHEHJ,AHEHJ,AHEHJ,AHEHJ
GAAGC AAAAA GAAGC AAAAA GAAGC AAAAA GAAGC AAAAA GAAGC AAAAA GAAGC AAAAA GAAGC AAAAA GAAGC AAAAA GAAGC AAAAA GAAGC AAAAA GAAGC AAAAA GAAGC AAAAA GAAGC AAAAA GAAGC AAAAA GAAGC AAAAA GAAGC AAAAA GAAGC AAAAA GAAGC AAAAA GAAGC AAAAA GAAGC AAAAA GAAGC AAAAA GAAGC AAAAA GAAGC AAAAA GAAGC AAAAA GAAGC AAAAA 
AAAAA AJCBJ JIFJA ABGIF FIGIE GBAID FJBFI AEFGI IEIHJ IBAHA HBDJJ ICJFI BHDGH ABCIF EEFJE DBDFG IADEA GIJJB ECDEH HCIFJ HIABJ JIJCB FJJDG FJBFI JFIAB AEFGI IEIHJ EIHHB FJDJI HFCDJ HCGIH HBEBE BJCHG GABGA FJBFI JFIAB AEFGI IEIHJ GDAAI JHHCA EGIDH BEFFG DCDHA CDFDB JBFFE GCHEE JFICH GBGBF IAAGH FJBFI AEFGI
BHDGH: ABCIF
HFCDJ: HCGIH
JFICH: GBGBF
FIGIE: GBAID
IAAGH: FJBFI
BJCHG: GABGA
JBFFE: GCHEE
GIJJB: ECDEH
IADEA: GIJJB
HBEBE: BJCHG
JIJCB: FJJDG
IBAHA: HBDJJ
JIFJA: ABGIF
GABGA: FJBFI
JFIAB: AEFGI,AEFGI
JFIAB AAAAA JFIAB AAAAA JFIAB AAAAA JFIAB AAAAA JFIAB AAAAA JFIAB AAAAA JFIAB AAAAA JFIAB AAAAA JFIAB AAAAA JFIAB AAAAA JFIAB AAAAA JFIAB AAAAA JFIAB AAAAA JFIAB AAAAA JFIAB AAAAA JFIAB AAAAA JFIAB AAAAA JFIAB AAAAA JFIAB AAAAA JFIAB AAAAA JFIAB AAAAA JFIAB AAAAA JFIAB AAAAA JFIAB AAAAA JFIAB AAAAA 
AAAAA BEJBI BHIJD IJGGD GGBGB ICGIH FDIGI JJAHE BHEAG HAJGJ DBIAI AFGEA FBDIJ HADDA BHAAD DGDHD DDCJC FBFGA IDJCC GHDDI BHEAG DBIAI AFGEA DHFGE CEBBF HDDDJ EEADA HGEIJ FFIHF DEIFH FGDJA BFHFE HAJGJ DBIAI AFGEA ACJEI BADIG FAFHE IICIE IJABJ JIEBF HGAGI JHGGJ HAJGJ DBIAI AFGEA DHGBD AIEAA JCCBH CHDDF JAJGF
HGAGI: JHGGJ
IJABJ: JIEBF
FDIGI: JJAHE
IDJCC: GHDDI
BEJBI: BHIJD
IICIE: IJABJ
CEBBF: HDDDJ
JAJGF: 
ACJEI: BADIG
JJAHE: BHEAG
DEIFH: FGDJA
ICGIH: FDIGI
HDDDJ: EEADA
FAFHE: IICIE
DBIAI: AFGEA,AFGEA,AFGEA,AFGEA
DBIAI AAAAA DBIAI AAAAA DBIAI AAAAA DBIAI AAAAA DBIAI AAAAA DBIAI AAAAA DBIAI AAAAA DBIAI AAAAA DBIAI AAAAA DBIAI AAAAA DBIAI AAAAA DBIAI AAAAA DBIAI AAAAA DBIAI AAAAA DBIAI AAAAA DBIAI AAAAA DBIAI AAAAA DBIAI AAAAA DBIAI AAAAA DBIAI AAAAA DBIAI AAAAA DBIAI AAAAA DBIAI AAAAA DBIAI AAAAA DBIAI AAAAA 
AAAAA BEEIJ AIEAD GJFJF IBGGA CCGBA EIHFA HIBAG HGJHE HBBIC CIAIA EIHII BHCHG JBAHH HCJHD JIDEA JGJDH DBEBB BHFHF DAHCD JHEDA CIAIA EIHII BHCHG JAHJJ BCBAH AABBG IEGCC GHJHH JJFHG GCBBG IDCGA CIAIA EIHII BHCHG HJAJG EAGED GICGJ GFJED GGFIC DEEHG FAIDD IHAFB BBJCE CIAIA EIHII BHCHG EAJBF IBGJA DEIDJ DCDED
GGFIC: DEEHG
EIHII: BHCHG,BHCHG,BHCHG,BHCHG
EIHII AAAAA EIHII AAAAA EIHII AAAAA EIHII AAAAA EIHII AAAAA EIHII AAAAA EIHII AAAAA EIHII AAAAA EIHII AAAAA EIHII AAAAA EIHII AAAAA EIHII AAAAA EIHII AAAAA EIHII AAAAA EIHII AAAAA EIHII AAAAA EIHII AAAAA EIHII AAAAA EIHII AAAAA EIHII AAAAA EIHII AAAAA EIHII AAAAA EIHII AAAAA EIHII AAAAA EIHII AAAAA 
AAAAA GADCA CFAAI GGBBD IBCFE ABEGI BDBJH FGGAE IBBFJ GCAFE CFJJE JJIGE HEBJA BCBBH BAHAE HEDFE AAFFB HBGFE JBADC FHBDJ BDBJH GCAFE CCCDI IDHDC CFJJE JJIGE CHJHD IJJAD JDAJD CGAFE BIBHH JDECD EIAIE AIGIC ICHGF IDHDC CFJJE JJIGE HCDEE JABJA FHBDC EDEGA DFDBD BCGBC JGBCF ABJII EIBBI GCAFE CFJJE JJIGE HICDE
AAFFB: HBGFE
IBCFE: ABEGI
BCGBC: JGBCF
JGBCF: ABJII
CCCDI: IDHDC
ICHGF: IDHDC
BAHAE: HEDFE
HEDFE: AAFFB
EDEGA: DFDBD
GADCA: CFAAI
IDHDC: CFJJE,CFJJE
IDHDC AAAAA IDHDC AAAAA IDHDC AAAAA IDHDC AAAAA IDHDC AAAAA IDHDC AAAAA IDHDC AAAAA IDHDC AAAAA IDHDC AAAAA IDHDC AAAAA IDHDC AAAAA IDHDC AAAAA IDHDC AAAAA IDHDC AAAAA IDHDC AAAAA IDHDC AAAAA IDHDC AAAAA IDHDC AAAAA IDHDC AAAAA IDHDC AAAAA IDHDC AAAAA IDHDC AAAAA IDHDC AAAAA IDHDC AAAAA IDHDC AAAAA 
AAAAA HFIFH EDGCH DGHGF IHGHB GAAAI IFHFD AECJJ IDCAB EDAED HJJGH CAAAG HHCGJ BFFCG GCEGA DEBIE GCJJC IIFFA IDCAB EDAED BBABF DCJAF GGCIB AJABE CEEGB HBCEF DJBCJ IDBCA EAHFG IFJAH IIFFA IDCAB EDAED BEGIH ICGII AHIFD GAAAI FDHCH JIGBD FCHHI AECJJ IIFFA IDCAB EDAED EBFCJ FIEGC BIDDC JGAFE DAHFF FJJFD HIFHF
AJABE: CEEGB
HIFHF: 
GAAAI: IFHFD,FDHCH
EDAED: HJJGH,BBABF,BEGIH,EBFCJ
IDCAB: EDAED,EDAED,EDAED,EDAED
IDCAB AAAAA IDCAB AAAAA IDCAB AAAAA IDCAB AAAAA IDCAB AAAAA IDCAB AAAAA IDCAB AAAAA IDCAB AAAAA IDCAB AAAAA IDCAB AAAAA IDCAB AAAAA IDCAB AAAAA IDCAB AAAAA IDCAB AAAAA IDCAB AAAAA IDCAB AAAAA IDCAB AAAAA IDCAB AAAAA IDCAB AAAAA IDCAB AAAAA IDCAB AAAAA IDCAB AAAAA IDCAB AAAAA IDCAB AAAAA IDCAB AAAAA 
AAAAA BCDBC GDGFE GDHHA CDHAF JGJJG FJHJC EDACH CJHGH HJFAI GIAHC IACEI CIGFB DGFGA FGHCB HEBEC JCFCH IIGCE ADJIJ ADJED AIFBA BFCEG GGIHD CIGFB DGFGA EGFHC ACEAE JJIDC FCJFG EBACE HEHDB DEEII EBIBF CJJJC CIGFB DGFGA CCJJE IIABC BIAJC AEJDI JJAJJ GIEIH ICAHC BCIDG EGIHC GGIHD CIGFB DGFGA BFFFC GHJFA HCCAJ
CDHAF: JGJJG
DGFGA: FGHCB,EGFHC,CCJJE,BFFFC
EDACH: CJHGH
IIGCE: ADJIJ
HCCAJ: 
JJIDC: FCJFG
CJJJC: CIGFB
EBIBF: CJJJC
FCJFG: EBACE
ADJIJ: ADJED
EGFHC: ACEAE
HEHDB: DEEII
HJFAI: GIAHC
GIEIH: ICAHC
BIAJC: AEJDI
GGIHD: CIGFB,CIGFB
GGIHD AAAAA GGIHD AAAAA GGIHD AAAAA GGIHD AAAAA GGIHD AAAAA GGIHD AAAAA GGIHD AAAAA GGIHD AAAAA GGIHD AAAAA GGIHD AAAAA GGIHD AAAAA GGIHD AAAAA GGIHD AAAAA GGIHD AAAAA GGIHD AAAAA GGIHD AAAAA GGIHD AAAAA GGIHD AAAAA GGIHD AAAAA GGIHD AAAAA GGIHD AAAAA GGIHD AAAAA GGIHD AAAAA GGIHD AAAAA GGIHD AAAAA 
AAAAA GJCAE JJDCA CFDHD AHCEB JCGJA FBJCA DCGGF FJFGA AHBHC EJFFD IDIJH JIDBB ACGGB HHBHC GBHJJ GHGHI CEJFE GJCAJ FBJCA JACAF EJFFD GJCJE IDIJH JIDBB GIICD GGDIJ HHCJI BACCG IGBGH CIDID DEACE HHJBG HGGCH AHBHC HBHBE GJCJE IDIJH JIDBB BICAI BCBFE FAFJH HJECA IDHEC DEJGA BAJIG EFCIA HGFGG BFIJH IIGGE AHBHC
GGDIJ: HHCJI
BACCG: IGBGH
GHGHI: CEJFE
JCGJA: FBJCA
AHCEB: JCGJA
GJCJE: IDIJH,IDIJH
GJCJE AAAAA GJCJE AAAAA GJCJE AAAAA GJCJE AAAAA GJCJE AAAAA GJCJE AAAAA GJCJE AAAAA GJCJE AAAAA GJCJE AAAAA GJCJE AAAAA GJCJE AAAAA GJCJE AAAAA GJCJE AAAAA GJCJE AAAAA GJCJE AAAAA GJCJE AAAAA GJCJE AAAAA GJCJE AAAAA GJCJE AAAAA GJCJE AAAAA GJCJE AAAAA GJCJE AAAAA GJCJE AAAAA GJCJE AAAAA GJCJE AAAAA 
AAAAA FCJGF AACFE GCICD BBCHE JHFCF BHJAI DBCEG GFHAC CBJAJ HFFBJ AADFG FHBAI AICFA JDAHJ DDBBD JFGBB HJIBD FGGAI JEFDE DBHHD DBCEG JGCBF IABBH FHBAI AICFA CIGDC DAAIG EIIFG DFHBA FJCIE AJDJE HFHFA ADHIH DCFAG AADFG FHBAI AICFA IHBCI HHJJF AACHJ CDDAD EDIFE AGGCE EBJBD DCJBB DBHHD IEIBA FJCIE JGCBF HFFBJ
FCJGF: AACFE
FHBAI: AICFA,AICFA,AICFA
AICFA FHBAI AAAAA FHBAI AAAAA FHBAI AAAAA FHBAI AAAAA FHBAI AAAAA FHBAI AAAAA FHBAI AAAAA FHBAI AAAAA FHBAI AAAAA FHBAI AAAAA FHBAI AAAAA FHBAI AAAAA FHBAI AAAAA FHBAI AAAAA FHBAI AAAAA FHBAI AAAAA FHBAI AAAAA FHBAI AAAAA FHBAI AAAAA FHBAI AAAAA FHBAI AAAAA FHBAI AAAAA FHBAI AAAAA FHBAI AAAAA FHBAI 
AAAAA JAEIA HIBFF AJHBF GAGAF EBEAF BBCEC DJEEA IDCCI EDFIF BEEGI GFAAA DBGAE CAEIH BAGHG BCGHB JHGHJ IIACH CBFBC JHCCD IDACI AEFBB EDGDC BJGCB JEJAA BECJJ CAEIH BAGHG BCGHB FIBDE GDJGA DECGB DDHED IFBFH GEGID DBGAE CAEIH BAGHG BCGHB JCIHH GDDHI EIDFI FEHIA CGAEH IIIFD AHBIB IEHCJ AEJAI HGGGC EDFIF BAJEA
BEEGI: GFAAA
AEFBB: EDGDC
IDACI: AEFBB
BECJJ: CAEIH
GEGID: DBGAE
IEHCJ: AEJAI
BAJEA: 
EDFIF: BEEGI,BAJEA
AHBIB: IEHCJ
BCGHB: JHGHJ,FIBDE,JCIHH
GAGAF: EBEAF
EBEAF: BBCEC
CGAEH: IIIFD
EDGDC: BJGCB
BBCEC: DJEEA
BAGHG: BCGHB,BCGHB,BCGHB
BAGHG AAAAA BAGHG AAAAA BAGHG AAAAA BAGHG AAAAA BAGHG AAAAA BAGHG AAAAA BAGHG AAAAA BAGHG AAAAA BAGHG AAAAA BAGHG AAAAA BAGHG AAAAA BAGHG AAAAA BAGHG AAAAA BAGHG AAAAA BAGHG AAAAA BAGHG AAAAA BAGHG AAAAA BAGHG AAAAA BAGHG AAAAA BAGHG AAAAA BAGHG AAAAA BAGHG AAAAA BAGHG AAAAA BAGHG AAAAA BAGHG AAAAA 
AAAAA JEICF IGICH HCFAF AFEAD EBAFH JAHHI HJEFC EDEEA IIIDD JCJCE EAJBF EFHJI DFDFB GEDEF AJIHJ ABCEA AJHBJ BIFFH BHDDJ CFJFD AEJJE EDEEA HCGBB DCJEI JCJCE EFHJI DFDFB JAJHG FDGBD FBGCD AEBIF HDBHG EAJJC EAJBF EFHJI DFDFB EGHJG BIHFG CAEJA BJFJD JAJCG BDCGH HGJDA AEJJE CFIGF ICDHH FEBFI JABHH EAJBF EFHJI
ICDHH: FEBFI
BHDDJ: CFJFD
CFIGF: ICDHH
EGHJG: BIHFG
BIHFG: CAEJA
EAJBF: EFHJI,EFHJI,EFHJI
EAJBF AAAAA EAJBF AAAAA EAJBF AAAAA EAJBF AAAAA EAJBF AAAAA EAJBF AAAAA EAJBF AAAAA EAJBF AAAAA EAJBF AAAAA EAJBF AAAAA EAJBF AAAAA EAJBF AAAAA EAJBF AAAAA EAJBF AAAAA EAJBF AAAAA EAJBF AAAAA EAJBF AAAAA EAJBF AAAAA EAJBF AAAAA EAJBF AAAAA EAJBF AAAAA EAJBF AAAAA EAJBF AAAAA EAJBF AAAAA EAJBF AAAAA 
AAAAA FGCIE GCHFH GJIJF IBEDI CFCBH FDAIC AAEHA HBCGC EHACG AHHAD BJBDG GDCHF CDJBH GHBGC CAEHG ADIGG JBBAA IGCFI BBGDJ EFIFI HBCGC EHACG EBGAA IBACE FIFDD IEIGI EDEAG BIEDI DFGCC ICFJB JGFFJ DJFHG CGJDI EADAE FBIGH HBCGC EHACG IDCJA ICJAH HGDHD JEAJF ECHAG GHHGD EGIAB JIJDF JIFHC AAJHD CBEHE BBGJG GBFFG
GHHGD: EGIAB
BIEDI: DFGCC
CDJBH: GHBGC
GHBGC: CAEHG
ADIGG: JBBAA
EDEAG: BIEDI
IEIGI: EDEAG
DFGCC: ICFJB
GDCHF: CDJBH
IBACE: FIFDD
EGIAB: JIJDF
JIFHC: AAJHD
FIFDD: IEIGI
AAEHA: HBCGC
AAJHD: CBEHE
CFCBH: FDAIC
CGJDI: EADAE
JEAJF: ECHAG
FDAIC: AAEHA
BBGJG: GBFFG
BBGDJ: EFIFI
BJBDG: GDCHF
JBBAA: IGCFI
DJFHG: CGJDI
AHHAD: BJBDG
ICJAH: HGDHD
ICFJB: JGFFJ
HGDHD: JEAJF
CAEHG: ADIGG
EBGAA: IBACE
GJIJF: IBEDI
IDCJA: ICJAH
FBIGH: HBCGC
ECHAG: GHHGD
GCHFH: GJIJF
IGCFI: BBGDJ
EHACG: AHHAD,EBGAA,IDCJA
JGFFJ: DJFHG
AAAAA: FGCIE
CBEHE: BBGJG
EADAE: FBIGH
JIJDF: JIFHC
FGCIE: GCHFH
GBFFG: 
IBEDI: CFCBH
HBCGC: EHACG,EHACG,EHACG
EHACG HBCGC AAAAA HBCGC AAAAA HBCGC AAAAA HBCGC AAAAA HBCGC AAAAA HBCGC AAAAA HBCGC AAAAA HBCGC AAAAA HBCGC AAAAA HBCGC AAAAA HBCGC AAAAA HBCGC AAAAA HBCGC AAAAA HBCGC AAAAA HBCGC AAAAA HBCGC AAAAA HBCGC AAAAA HBCGC AAAAA HBCGC AAAAA HBCGC AAAAA HBCGC AAAAA HBCGC AAAAA HBCGC AAAAA HBCGC AAAAA HBCGC 
AAAAA IIGBD GCEHE DFFJG JAJFF GJIFA AIIHH IHDEC BCJDG FFFAC CIGHJ IHJDC HAEGI CFGAE DJGFI IAAEJ GGFIF HJIAB DAEED AEFCI AECBI DFGFI EFHHE GABJC BBHIE FBCAD HADCI IHJDC HAEGI HFGII CIDIG FDIBJ CEIII HGJHJ JHEDA DHEIA IECCD HADCI IHJDC HAEGI DIDBG CBJHG BHDCE ABBJF EBIBG HHDDF ICJDJ HGCCB CJCED CIGHJ CCGJE
CCGJE: 
GJIFA: AIIHH
AEFCI: AECBI
DIDBG: CBJHG
HJIAB: DAEED
GABJC: BBHIE
IHDEC: BCJDG
DFFJG: JAJFF
JHEDA: DHEIA
ABBJF: EBIBG
HHDDF: ICJDJ
DHEIA: IECCD
HADCI: IHJDC,IHJDC
AAAAA HADCI AAAAA HADCI AAAAA HADCI AAAAA HADCI AAAAA HADCI AAAAA HADCI AAAAA HADCI AAAAA HADCI AAAAA HADCI AAAAA HADCI AAAAA HADCI AAAAA HADCI AAAAA HADCI AAAAA HADCI AAAAA HADCI AAAAA HADCI AAAAA HADCI AAAAA HADCI AAAAA HADCI AAAAA HADCI AAAAA HADCI AAAAA HADCI AAAAA HADCI AAAAA HADCI AAAAA HADCI 
AAAAA IFJFE AHIDI CIECC HAGHG HAGFA EBHHF AEIDC BCIFF HEIIB DCHHC DJCEJ FDBCH FGCJA HCGEI BEIGJ DDAEF AIJEE FBFAF GICGH AHCCE JEACC BJDGH BHGGJ DJCEJ FDBCH IFCCB CEECJ BAAJH AJJGJ IJIGD BGJJG GFIFF EEHCD BHGGJ DJCEJ FDBCH GBDII FAGGF AIGIF FIFAC EAHFC GDBGH FCBJB FIJIC EBAJF DJCEJ FDBCH DFADJ CDADA IHFCD
DCHHC: DJCEJ
FBFAF: GICGH
EAHFC: GDBGH
AHCCE: JEACC
DFADJ: CDADA
BJDGH: BHGGJ
FCBJB: FIJIC
CIECC: HAGHG
BCIFF: HEIIB
IFJFE: AHIDI
AIGIF: FIFAC
GDBGH: FCBJB
AEIDC: BCIFF
IHFCD: 
HAGHG: HAGFA
DJCEJ: FDBCH,FDBCH,FDBCH,FDBCH
DJCEJ AAAAA DJCEJ AAAAA DJCEJ AAAAA DJCEJ AAAAA DJCEJ AAAAA DJCEJ AAAAA DJCEJ AAAAA DJCEJ AAAAA DJCEJ AAAAA DJCEJ AAAAA DJCEJ AAAAA DJCEJ AAAAA DJCEJ AAAAA DJCEJ AAAAA DJCEJ AAAAA DJCEJ AAAAA DJCEJ AAAAA DJCEJ AAAAA DJCEJ AAAAA DJCEJ AAAAA DJCEJ AAAAA DJCEJ AAAAA DJCEJ AAAAA DJCEJ AAAAA DJCEJ AAAAA 
AAAAA GCGEH EBHDD DDBDB EBIHH AJEBH IADBD CJDGH GABBB FHCGE FEBJG FCIBG HHAGC IDEIB GIEBA DABGB DIFJH CIIIC CCHGF IBHFJ JDGJD JFEAI CJFJE ICGBI FCIBG HHAGC HEFEI DGBFJ BBEDD HGDFA CGDJD IBFDF CGCJG FEBJG FCIBG HHAGC GEAGI GCFDD EBBAD IGECD CIHCC EJHJB JFCAJ IDJEB FCIBG HHAGC JEACH JCHGI JFGBI IEACH JAGIG
GIEBA: DABGB
DGBFJ: BBEDD
JCHGI: JFGBI
CCHGF: IBHFJ
GCGEH: EBHDD
CIIIC: CCHGF
HEFEI: DGBFJ
IBFDF: CGCJG
CJFJE: ICGBI
HGDFA: CGDJD
CIHCC: EJHJB
CGDJD: IBFDF
IDJEB: FCIBG
JFCAJ: IDJEB
IDEIB: GIEBA
DABGB: DIFJH
IADBD: CJDGH
JFEAI: CJFJE
EBHDD: DDBDB
GEAGI: GCFDD
BBEDD: HGDFA
FEBJG: FCIBG,FCIBG
FEBJG AAAAA FEBJG AAAAA FEBJG AAAAA FEBJG AAAAA FEBJG AAAAA FEBJG AAAAA FEBJG AAAAA FEBJG AAAAA FEBJG AAAAA FEBJG AAAAA FEBJG AAAAA FEBJG AAAAA FEBJG AAAAA FEBJG AAAAA FEBJG AAAAA FEBJG AAAAA FEBJG AAAAA FEBJG AAAAA FEBJG AAAAA FEBJG AAAAA FEBJG AAAAA FEBJG AAAAA FEBJG AAAAA FEBJG AAAAA FEBJG AAAAA 
AAAAA EEDBC AHCCH JGCIE ICAHF GHADF EEJJA GHDBC HABBI ADHJE DICDD ACCEC CFDBF HHJAF HBBAJ JABFD FHGHE ABBJG JFGJF BDBDF JEEBE AIBHH ACCEC GJAEA CFDBF HHJAF IAEGI FCCDE EIAEJ CFBFD CDHCI BJEID CJIJA ADBIH FAHAJ GFCBH JEAGA FCFFI CEDCC JCCFC FAIDB DICDD ACCEC CFDBF HHJAF EBGDH ICCFD JCCBA AHEIE IAHIC GCBDH
DICDD: ACCEC,ACCEC
DICDD AAAAA DICDD DICDD DICDD DICDD DICDD DICDD DICDD DICDD DICDD AAAAA DICDD DICDD DICDD DICDD DICDD DICDD AAAAA DICDD DICDD AAAAA DICDD DICDD AAAAA DICDD AAAAA DICDD DICDD AAAAA DICDD DICDD DICDD AAAAA DICDD DICDD DICDD DICDD DICDD DICDD DICDD DICDD DICDD DICDD DICDD DICDD DICDD DICDD DICDD DICDD 
AAAAA BDAFD GFDHH HBEGC FIHHF EJAHD BDACH IEFIG AAJAH JADEF BEJFJ FACDD CBDHC GCBCG EGFGG BEJFJ FACDD AAADJ EIBJA HEGBJ AHFIJ IADDJ FEGAH EJHAE BDJJI AAJAH JADEF AFIIA BEJFJ FACDD JEJHH IEDFA FCHAD ACIJF DJBAC HCHIB DFIAJ HGGED AFGBI HIDBD AAJAH JADEF AFIIA BEJFJ FACDD AIBBH GBEFD JEIFC BIHGF CBFGA IIEDE
GCBCG: EGFGG
AFIIA: BEJFJ,BEJFJ
AFIIA AAAAA AFIIA AAAAA AFIIA AAAAA AFIIA AAAAA AFIIA AAAAA AFIIA AAAAA AFIIA AAAAA AFIIA AAAAA AFIIA AAAAA AFIIA AAAAA AFIIA AAAAA AFIIA AAAAA AFIIA AAAAA AFIIA AAAAA AFIIA AAAAA AFIIA AAAAA AFIIA AAAAA AFIIA AAAAA AFIIA AAAAA AFIIA AAAAA AFIIA AAAAA AFIIA AAAAA AFIIA AAAAA AFIIA AAAAA AFIIA AAAAA 
AAAAA GHIHJ BEABF JHJIG GJBDD HAJJI DDFJA BCJFC AAEAH BHHJG CJAHG EAAGB IEJHB AIFCE FHECB GHCCB HAEHG CHEAA ABEEH CDFJG BBFDA EHFAI DECDF CJAHG BAGEI EAAGB IEJHB DCEDI IBABJ DHIFC FCHAJ GJGFG GHBBI IAGIA DEECF IEFAC BJIIA EAAGB IEJHB IJIIA EBEBJ DHDDH FFBJI DHCJG GAFBA DGDGB CBDEB FABFC BHHJG CJAHG BAGEI
ABEEH: CDFJG
DHIFC: FCHAJ
DEECF: IEFAC
DECDF: CJAHG
IEFAC: BJIIA
JHJIG: GJBDD
HAJJI: DDFJA
CJAHG: EAAGB,BAGEI,BAGEI
BAGEI: EAAGB
AAEAH: BHHJG
GHCCB: HAEHG
EAAGB: IEJHB,IEJHB,IEJHB
IEJHB EAAGB AAAAA EAAGB AAAAA EAAGB AAAAA EAAGB AAAAA EAAGB AAAAA EAAGB AAAAA EAAGB AAAAA EAAGB AAAAA EAAGB AAAAA EAAGB AAAAA EAAGB AAAAA EAAGB AAAAA EAAGB AAAAA EAAGB AAAAA EAAGB AAAAA EAAGB AAAAA EAAGB AAAAA EAAGB AAAAA EAAGB AAAAA EAAGB AAAAA EAAGB AAAAA EAAGB AAAAA EAAGB AAAAA EAAGB AAAAA EAAGB 
AAAAA ICJGE JFICC JCCBB CDFDD BGIGB JDHBB GFIAH IJAFE JEIFB JAFEA FBBJD GJHGB ICFGI JHDEG AFFDJ CEAJD CAGFC AJADA JBBIC DIJAG DBIBD DCHFI BFFJI IFHBC DHFCF HFDCJ JABJG JAFEA FBBJD GJHGB ABHHI IAIAH IHBBE CGFFF BJHDE EFAED AEIDE EEIFH BBCHG IBHGE DCJIH AGHIC CFIGE JAGJC CHEJG FBBJD GJHGB CDEJB AJHDA CHICE
CHICE: 
BGIGB: JDHBB
JFICC: JCCBB
DBIBD: DCHFI
CGFFF: BJHDE
BFFJI: IFHBC
IJAFE: JEIFB
HFDCJ: JABJG
JAGJC: CHEJG
JHDEG: AFFDJ
GJHGB: ICFGI,ABHHI,CDEJB
AGHIC: CFIGE
DCHFI: BFFJI
JAFEA: FBBJD,FBBJD
JAFEA JAFEA AAAAA JAFEA AAAAA JAFEA AAAAA JAFEA JAFEA JAFEA AAAAA JAFEA AAAAA JAFEA AAAAA JAFEA AAAAA JAFEA AAAAA JAFEA JAFEA AAAAA JAFEA JAFEA AAAAA JAFEA AAAAA JAFEA JAFEA JAFEA JAFEA JAFEA AAAAA JAFEA AAAAA JAFEA AAAAA JAFEA JAFEA AAAAA JAFEA JAFEA JAFEA JAFEA JAFEA AAAAA JAFEA AAAAA JAFEA AAAAA 
AAAAA GIJGH JFJEA CJCCB GGHDH AEGIH AGGIJ AEFGB GBEFF FJAGG FGBGB FJFAA HBGHI AGEJC AIJHB DJIAF AEGIH AGGIJ DIGJC GJCEG HBIJE GAEJD AHAEA BGAJB GBBCJ FAHAC EFFDC IJDDH HIAHG DJIAF HBGCG AEGIH AGGIJ BADBD HGHBH DAJGC EJGIF EGIBI GADHI HHGFH AIBEH HDGAG FACGD EAFGF DJIAF AEGIH AGGIJ CBGJF EEGJD HCAJH EDFGB
EAFGF: DJIAF
DIGJC: GJCEG
AGEJC: AIJHB
IJDDH: HIAHG
GADHI: HHGFH
DAJGC: EJGIF
FGBGB: FJFAA
AIBEH: HDGAG
DJIAF: AEGIH,HBGCG,AEGIH
EFFDC: IJDDH
GBBCJ: FAHAC
FAHAC: EFFDC
GGHDH: AEGIH
AIJHB: DJIAF
HBGCG: AEGIH
EEGJD: HCAJH
GJCEG: HBIJE
AEFGB: GBEFF
GAEJD: AHAEA
GIJGH: JFJEA
HIAHG: DJIAF
GBEFF: FJAGG
JFJEA: CJCCB
AEGIH: AGGIJ,AGGIJ,AGGIJ,AGGIJ
AEGIH AAAAA AEGIH AAAAA AEGIH AAAAA AEGIH AAAAA AEGIH AAAAA AEGIH AAAAA AEGIH AAAAA AEGIH AAAAA AEGIH AAAAA AEGIH AAAAA AEGIH AAAAA AEGIH AAAAA AEGIH AAAAA AEGIH AAAAA AEGIH AAAAA AEGIH AAAAA AEGIH AAAAA AEGIH AAAAA AEGIH AAAAA AEGIH AAAAA AEGIH AAAAA AEGIH AAAAA AEGIH AAAAA AEGIH AAAAA AEGIH AAAAA 
AAAAA EAIHH EJEHG BIEAJ CHAJE GABAI DAHBA JBIEF JHEFI FDFJI JBAFC FCHEE CEGBG EEBDB EFFDD HFDIF EBJDE HBAEB GAICJ JBIEF JHEFI GFEHD BCABI GADFA GADIF HFFJH IEAIE BICGG HGJGF ABCFB JBIEF JHEFI CBJJB JJEJJ IJDJJ JEHDB FGHDF JEGHE DJCJH BGDFI HBAEB GAICJ JBIEF JHEFI BCJJF JHAEC ICFAB FDIGA EDBHE GBBEG EFGBE
JBIEF: JHEFI,JHEFI,JHEFI,JHEFI
JBIEF AAAAA JBIEF AAAAA JBIEF AAAAA JBIEF AAAAA JBIEF AAAAA JBIEF AAAAA JBIEF AAAAA JBIEF AAAAA JBIEF AAAAA JBIEF AAAAA JBIEF AAAAA JBIEF AAAAA JBIEF AAAAA JBIEF AAAAA JBIEF AAAAA JBIEF AAAAA JBIEF AAAAA JBIEF AAAAA JBIEF AAAAA JBIEF AAAAA JBIEF AAAAA JBIEF AAAAA JBIEF AAAAA JBIEF AAAAA JBIEF AAAAA 
AAAAA AFEDA JEAGA DGJBC JAJHI EGCDH IGIEE FBJDG ADDIH ABJJJ DJJHA GEAFC AGFCI CHAIA FABHI EGGEJ FIAHF HGEHH GBFDF HEGAE CDDHI DHFIE FJFBI CHAIA FABHI DBEGC AIHJF HBFFJ GDGFA DCHAB DJJHA AEBEE FJFBI CHAIA FABHI GFJEC HDIIG IICCI GCCBA JCIII HIDDB GAHFJ FFGJG CJCFI AHHII IIGJD AEBEE AGFCI CHAIA FABHI FABGE
HGEHH: GBFDF
HEGAE: CDDHI
FFGJG: CJCFI
JCIII: HIDDB
GAHFJ: FFGJG
DHFIE: FJFBI
ADDIH: ABJJJ
FABHI: EGGEJ,DBEGC,GFJEC,FABGE
GEAFC: AGFCI
GFJEC: HDIIG
FIAHF: HGEHH
HDIIG: IICCI
GBFDF: HEGAE
CJCFI: AHHII
DGJBC: JAJHI
HBFFJ: GDGFA
EGGEJ: FIAHF
JEAGA: DGJBC
AGFCI: CHAIA,CHAIA
AGFCI AGFCI AGFCI AGFCI AGFCI AGFCI AGFCI AGFCI AAAAA AGFCI AAAAA AGFCI AGFCI AAAAA AGFCI AGFCI AGFCI AGFCI AGFCI AAAAA AGFCI AAAAA AGFCI AGFCI AGFCI AAAAA AGFCI AAAAA AGFCI AAAAA AGFCI AAAAA AGFCI AGFCI AAAAA AGFCI AAAAA AGFCI AGFCI AGFCI AAAAA AGFCI AGFCI AAAAA AGFCI AAAAA AGFCI AGFCI AGFCI AAAAA 
